\bscra	ğ“ª
\guilsinglright	â€º
\bisansc	ğ™˜
\:ghost:	ğŸ‘»
\:briefs:	ğŸ©²
\Re	â„œ
\:children_crossing:	ğŸš¸
\bbz	ğ•«
\:sewing_needle:	ğŸª¡
\urcorner	âŒ
\frakY	ğ”œ
\^2	Â²
\pi	Ï€
\nless	â‰®
\:rooster:	ğŸ“
\:shaved_ice:	ğŸ§
\bbF	ğ”½
\nrightarrow	â†›
\:sponge:	ğŸ§½
\:thread:	ğŸ§µ
\upsilon	Ï…
\bfrakq	ğ––
\copyright	Â©
\npreccurlyeq	â‹ 
\bfrakL	ğ•·
\:socks:	ğŸ§¦
\:flamingo:	ğŸ¦©
\:mens:	ğŸš¹
\:no_good:	ğŸ™…
\bisansX	ğ™“
\:crescent_moon:	ğŸŒ™
\backsimeq	â‹
\:placard:	ğŸª§
\:person_frowning:	ğŸ™
\bisansD	ğ˜¿
\hvlig	Æ•
\blockrighthalf	â–
\bscrB	ğ“‘
\ttn	ğš—
\:athletic_shoe:	ğŸ‘Ÿ
\:octopus:	ğŸ™
\:coconut:	ğŸ¥¥
\ldq	â€œ
\bsanskappa	ğ¹
\llcorner	âŒ
\circleddash	âŠ
\:drum_with_drumsticks:	ğŸ¥
\:relaxed:	â˜º
\:small_orange_diamond:	ğŸ”¸
\^l	Ë¡
\precneqq	âªµ
\urblacktriangle	â—¥
\succeqq	âª´
\nsupseteq	âŠ‰
\iota	Î¹
\:table_tennis_paddle_and_ball:	ğŸ“
\overbrace	â
\danger	â˜¡
\rightharpoondown	â‡
\RRightarrow	â­†
\:ninja:	ğŸ¥·
\bisansMu	ğ›
\isansZ	ğ˜¡
\impliedby	âŸ¸
\succapprox	âª¸
\Rsh	â†±
\:taurus:	â™‰
\:boot:	ğŸ‘¢
\:lab_coat:	ğŸ¥¼
\bsansvarrho	ğ
\pointint	â¨•
\original	âŠ¶
\nvtwoheadleftarrow	â¬´
\bsanspartial	ğ‰
\:skin-tone-2:	ğŸ»
\:open_mouth:	ğŸ˜®
\nBumpeq	â‰Ì¸
\bisanssigma	ğ¼
\frakD	ğ”‡
\clockoint	â¨
\rarrx	â¥‡
\itx	ğ‘¥
\underleftarrow	âƒ®
\bij	ğ’‹
\measangledltosw	â¦¯
\eqqsim	â©³
\:wc:	ğŸš¾
\:scarf:	ğŸ§£
\leo	â™Œ
\:white_flower:	ğŸ’®
\bfrakR	ğ•½
\DownArrowBar	â¤“
\surd	âˆš
\:six_pointed_star:	ğŸ”¯
\:smiling_imp:	ğŸ˜ˆ
\bbk	ğ•œ
\twoheaddownarrow	â†¡
\ointctrclockwise	âˆ³
\fraku	ğ”²
\bagmember	â‹¿
\ElOr	â©–
\bfvarTheta	ğš¹
\:raised_back_of_hand:	ğŸ¤š
\Otimes	â¨·
\isansp	ğ˜±
\:microphone:	ğŸ¤
\frakS	ğ”–
\frakG	ğ”Š
\measangledrtose	â¦®
\:ring:	ğŸ’
\doubleplus	â§º
\Game	â…
\_x	â‚“
\sanseight	ğŸª
\NestedGreaterGreater	âª¢
\pentagon	â¬ 
\supmult	â«‚
\bfu	ğ®
\sansLturned	â…‚
\:pig_nose:	ğŸ½
\bumpeqq	âª®
\leftarrowtriangle	â‡½
\itgamma	ğ›¾
\lnsim	â‹¦
\:bone:	ğŸ¦´
\itjmath	ğš¥
\gnapprox	âªŠ
\smallblacktriangleleft	â—‚
\twoheaduparrowcircle	â¥‰
\:butter:	ğŸ§ˆ
\:phone:	â˜
\:waning_crescent_moon:	ğŸŒ˜
\NotLeftTriangleBar	â§Ì¸
\nRightarrow	â‡
\veedoublebar	â©£
\backepsilon	Ï¶
\nsucccurlyeq	â‹¡
\biU	ğ‘¼
\ng	Å‹
\eqdef	â‰
\eqqslantless	âª›
\:mosque:	ğŸ•Œ
\:trident:	ğŸ”±
\:clock1130:	ğŸ•¦
\l	Å‚
\:cold_sweat:	ğŸ˜°
\bisansNu	ğœ
\:bouquet:	ğŸ’
\:t-rex:	ğŸ¦–
\lvertneqq	â‰¨ï¸€
\:older_man:	ğŸ‘´
\isansF	ğ˜
\S	Â§
\:earth_africa:	ğŸŒ
\backppprime	â€·
\leftdotarrow	â¬¸
\omega	Ï‰
\itNu	ğ›®
\fisheye	â—‰
\NotSquareSubset	âŠÌ¸
\boxcircle	â§‡
\isansu	ğ˜¶
\:top:	ğŸ”
\:european_post_office:	ğŸ¤
\sansy	ğ—’
\Bumpeq	â‰
\daleth	â„¸
\csub	â«
\bscrA	ğ“
\bsansTheta	ğ
\:rice:	ğŸš
\recorder	âŒ•
\cupvee	â©…
\:takeout_box:	ğŸ¥¡
\:kimono:	ğŸ‘˜
\isansc	ğ˜¤
\bbR	â„
\bbD	ğ”»
\bsanstheta	ğ·
\bfG	ğ†
\:star:	â­
\:magnet:	ğŸ§²
\shuffle	â§¢
\:a:	ğŸ…°
\ttK	ğ™º
\itC	ğ¶
\:fire_extinguisher:	ğŸ§¯
\:currency_exchange:	ğŸ’±
\:battery:	ğŸ”‹
\_phi	áµ©
\clomeg	É·
\^)	â¾
\:smiling_face_with_3_hearts:	ğŸ¥°
\bsansUpsilon	ğª
\:cup_with_straw:	ğŸ¥¤
\bigwhitestar	â˜†
\bigblacktriangleup	â–²
\circlevertfill	â—
\:cl:	ğŸ†‘
\:restroom:	ğŸš»
\:drop_of_blood:	ğŸ©¸
\frakA	ğ”„
\:skull:	ğŸ’€
\:white_medium_small_square:	â—½
\sansone	ğŸ£
\leftarrowplus	â¥†
\bbt	ğ•¥
\mars	â™‚
\ngtr	â‰¯
\:fried_shrimp:	ğŸ¤
\hksearow	â¤¥
\acidfree	â™¾
\bisansB	ğ˜½
\lesssim	â‰²
\parallelogramblack	â–°
\isansl	ğ˜­
\angles	â¦
\:cocktail:	ğŸ¸
\:first_place_medal:	ğŸ¥‡
\boxquestion	â°
\:green_heart:	ğŸ’š
\Sqcap	â©
\bisansg	ğ™œ
\:scorpion:	ğŸ¦‚
\^W	áµ‚
\bbeight	ğŸ 
\:passport_control:	ğŸ›‚
\:taco:	ğŸŒ®
\Colon	âˆ·
\:white_small_square:	â–«
\ltphi	É¸
\frakO	ğ”’
\bsansomega	ğˆ
\sagittarius	â™
\:yen:	ğŸ’´
\:broom:	ğŸ§¹
\biN	ğ‘µ
\sansv	ğ—
\dot	Ì‡
\Omega	Î©
\ttG	ğ™¶
\:wood:	ğŸªµ
\upoldKoppa	Ï˜
\:dragon_face:	ğŸ²
\:fortune_cookie:	ğŸ¥ 
\looparrowright	â†¬
\bisansR	ğ™
\:mountain_railway:	ğŸš
\fdiagovrdiag	â¤¬
\itchi	ğœ’
\ngeqslant	â©¾Ì¸
\^1	Â¹
\itl	ğ‘™
\bfrakJ	ğ•µ
\:broken_heart:	ğŸ’”
\:snake:	ğŸ
\:hedgehog:	ğŸ¦”
\biNu	ğœ¨
\pluseqq	â©²
\beta	Î²
\blkhorzoval	â¬¬
\twonotes	â™«
\mdblkdiamond	â¬¥
\ttnine	ğŸ¿
\itOmega	ğ›º
\approxnotequal	â‰†
\:cupid:	ğŸ’˜
\isansx	ğ˜¹
\:softball:	ğŸ¥
\subsetneqq	â«‹
\nvtwoheadrightarrowtail	â¤—
\bisansY	ğ™”
\neg	Â¬
\bscrx	ğ”
\itmu	ğœ‡
\barwedge	âŠ¼
\:worried:	ğŸ˜Ÿ
\sansL	ğ–«
\:minidisc:	ğŸ’½
\:carousel_horse:	ğŸ 
\bfkappa	ğ›‹
\leftbkarrow	â¤Œ
\nvtwoheadleftarrowtail	â¬¼
\:steam_locomotive:	ğŸš‚
\:carpentry_saw:	ğŸªš
\Cap	â‹’
\bsanss	ğ˜€
\^I	á´µ
\frakb	ğ”Ÿ
\bfz	ğ³
\:incoming_envelope:	ğŸ“¨
\ddddot	âƒœ
\:nauseated_face:	ğŸ¤¢
\_j	â±¼
\longrightarrow	âŸ¶
\bbW	ğ•
\:hear_no_evil:	ğŸ™‰
\:keycap_ten:	ğŸ”Ÿ
\:microscope:	ğŸ”¬
\varcarriagereturn	â
\dottedsquare	â¬š
\:clock4:	ğŸ•“
\:lock_with_ink_pen:	ğŸ”
\:bell:	ğŸ””
\lmoustache	â°
\^h	Ê°
\Equiv	â‰£
\ttr	ğš›
\capwedge	â©„
\:u7981:	ğŸˆ²
\accurrent	â¦
\draftingarrow	â›
\bbGamma	â„¾
\DH	Ã
\circleonleftarrow	â¬°
\egsdot	âª˜
\ttU	ğš„
\bfraks	ğ–˜
\bsansLambda	ğ 
\itc	ğ‘
\openbracketright	âŸ§
\vec	âƒ—
\bivartheta	ğ‘
\ttC	ğ™²
\:barber:	ğŸ’ˆ
\sansw	ğ—
\:scooter:	ğŸ›´
\bscrn	ğ“·
\:cancer:	â™‹
\bfrake	ğ–Š
\:family:	ğŸ‘ª
\L	Å
\ni	âˆ‹
\itvarkappa	ğœ˜
\:gift_heart:	ğŸ’
\vardiamondsuit	â™¦
\isansA	ğ˜ˆ
\itt	ğ‘¡
\ttH	ğ™·
\leftrightharpoonsdown	â¥§
\profsurf	âŒ“
\bialpha	ğœ¶
\_v	áµ¥
\:round_pushpin:	ğŸ“
\:toothbrush:	ğŸª¥
\:skunk:	ğŸ¦¨
\frakq	ğ”®
\:ambulance:	ğŸš‘
\bsansvarphi	ğ…
\:nose:	ğŸ‘ƒ
\:truck:	ğŸšš
\supsetplus	â«€
\bsansP	ğ—£
\bisansr	ğ™§
\:tamale:	ğŸ«”
\bivarepsilon	ğœº
\bbp	ğ•¡
\NotNestedLessLess	âª¡Ì¸
\bfL	ğ‹
\sqlozenge	âŒ‘
\:8ball:	ğŸ±
\:o:	â­•
\:u55b6:	ğŸˆº
\ttfour	ğŸº
\gtrless	â‰·
\:unlock:	ğŸ”“
\twoheadleftdbkarrow	â¬·
\:roller_coaster:	ğŸ¢
\:beginner:	ğŸ”°
\turnednot	âŒ™
\wedgedot	âŸ‘
\similarleftarrow	â­‰
\:apple:	ğŸ
\bsansu	ğ˜‚
\:no_mouth:	ğŸ˜¶
\rtlz	Ê
\:white_square_button:	ğŸ”³
\lescc	âª¨
\:field_hockey_stick_and_ball:	ğŸ‘
\sanso	ğ—ˆ
\isansY	ğ˜ 
\bisansU	ğ™
\:lungs:	ğŸ«
\vardoublebarwedge	âŒ†
\invwhiteupperhalfcircle	â—š
\hspace	â€Š
\:baby_chick:	ğŸ¤
\:baguette_bread:	ğŸ¥–
\rightdotarrow	â¤‘
\leqslant	â©½
\trnr	É¹
\frake	ğ”¢
\bsanschi	ğ†
\wedgeonwedge	â©•
\fullouterjoin	âŸ—
\:small_blue_diamond:	ğŸ”¹
\bscrD	ğ““
\isansj	ğ˜«
\:light_rail:	ğŸšˆ
\lmrk	Ë
\nHuparrow	â‡
\gamma	Î³
\simgE	âª 
\bflambda	ğ›Œ
\varstar	âœ¶
\:see_no_evil:	ğŸ™ˆ
\Doteq	â‰‘
\:closed_umbrella:	ğŸŒ‚
\:confetti_ball:	ğŸŠ
\ttD	ğ™³
\:dvd:	ğŸ“€
\:deer:	ğŸ¦Œ
\:mechanical_leg:	ğŸ¦¿
\bbn	ğ•Ÿ
\nsubset	âŠ„
\Equal	â©µ
\:elevator:	ğŸ›—
\:exclamation:	â—
\varhexagon	â¬¡
\sansr	ğ—‹
\bsansMu	ğ¡
\1/6	â…™
\bkarow	â¤
\bisanso	ğ™¤
\bfrakw	ğ–œ
\:checkered_flag:	ğŸ
\bscrq	ğ“º
\P	Â¶
\bfrakF	ğ•±
\napprox	â‰‰
\sansA	ğ– 
\:canoe:	ğŸ›¶
\ttT	ğšƒ
\:high_brightness:	ğŸ”†
\ltquest	â©»
\:koko:	ğŸˆ
\bisansk	ğ™ 
\bsansGamma	ğ˜
\lesseqgtr	â‹š
\smeparsl	â§¤
\bisansx	ğ™­
\:snowflake:	â„
\varnothing	âˆ…
\:bangbang:	â€¼
\rppolint	â¨’
\cirfr	â—‘
\:sweat_drops:	ğŸ’¦
\eta	Î·
\bisansa	ğ™–
\bsansU	ğ—¨
\:disappointed:	ğŸ˜
\:sos:	ğŸ†˜
\^gamma	áµ
\:spock-hand:	ğŸ––
\Vdash	âŠ©
\^G	á´³
\:speech_balloon:	ğŸ’¬
\:pager:	ğŸ“Ÿ
\:id:	ğŸ†”
\gemini	â™Š
\^ltphi	á¶²
\:loud_sound:	ğŸ”Š
\:pickup_truck:	ğŸ›»
\bivarsigma	ğ‡
\bff	ğŸ
\_1	â‚
\nsupset	âŠ…
\supsetneqq	â«Œ
\:squid:	ğŸ¦‘
\lesdotor	âªƒ
\dotequiv	â©§
\:fish_cake:	ğŸ¥
\:massage:	ğŸ’†
\bfvarrho	ğ› 
\bfrakG	ğ•²
\bigtriangleup	â–³
\underbar	Ì²
\:statue_of_liberty:	ğŸ—½
\ttj	ğš“
\itL	ğ¿
\:dizzy:	ğŸ’«
\:roll_of_paper:	ğŸ§»
\bimu	ğ
\image	âŠ·
\ita	ğ‘
\biEpsilon	ğœ 
\:clock830:	ğŸ•£
\:left_right_arrow:	â†”
\supdsub	â«˜
\sansfour	ğŸ¦
\smashtimes	â¨³
\Zeta	Î–
\nisd	â‹º
\biR	ğ‘¹
\DDownarrow	âŸ±
\bigamma	ğœ¸
\:mute:	ğŸ”‡
\bisansJ	ğ™…
\circledcirc	âŠš
\subsim	â«‡
\diameter	âŒ€
\:clock3:	ğŸ•’
\:innocent:	ğŸ˜‡
\:neutral_face:	ğŸ˜
\house	âŒ‚
\bfpsi	ğ›™
\towa	â¤ª
\:bullettrain_side:	ğŸš„
\schwa	É™
\in	âˆˆ
\bfe	ğ
\:selfie:	ğŸ¤³
\frakR	â„œ
\:kangaroo:	ğŸ¦˜
\:name_badge:	ğŸ“›
\:lobster:	ğŸ¦
\chi	Ï‡
\itD	ğ·
\:musical_score:	ğŸ¼
\biD	ğ‘«
\bsansR	ğ—¥
\mapsdown	â†§
\:bank:	ğŸ¦
\:hammer:	ğŸ”¨
\bsanspsi	ğ‡
\bfa	ğš
\squareurquad	â—³
\bfrakU	ğ–€
\bisanst	ğ™©
\smwhtlozenge	â¬«
\^V	â±½
\bbzero	ğŸ˜
\rightthreearrows	â‡¶
\ttzero	ğŸ¶
\:-1:	ğŸ‘
\:postal_horn:	ğŸ“¯
\bsansb	ğ—¯
\:man_with_gua_pi_mao:	ğŸ‘²
\:aquarius:	â™’
\bfrakg	ğ–Œ
\QED	âˆ
\^b	áµ‡
\bisansl	ğ™¡
\bbfive	ğŸ
\:ice_hockey_stick_and_puck:	ğŸ’
\:smirk_cat:	ğŸ˜¼
\scrm	ğ“‚
\its	ğ‘ 
\sansH	ğ–§
\:peach:	ğŸ‘
\:clock10:	ğŸ•™
\RightUpVectorBar	â¥”
\itX	ğ‘‹
\tts	ğšœ
\verymuchless	â‹˜
\rrbracket	âŸ§
\dicei	âš€
\:pinata:	ğŸª…
\squarenwsefill	â–§
\bfc	ğœ
\triangleq	â‰œ
\:boom:	ğŸ’¥
\:raising_hand:	ğŸ™‹
\:tractor:	ğŸšœ
\ogreaterthan	â§
\:curly_loop:	â°
\Beta	Î’
\bisansSigma	ğ¢
\ast	âˆ—
\bigsqcup	â¨†
\bsansq	ğ—¾
\:cool:	ğŸ†’
\bsansOmicron	ğ¤
\enclosesquare	âƒ
\:beers:	ğŸ»
\nequiv	â‰¢
\lat	âª«
\isansS	ğ˜š
\ttb	ğš‹
\ncong	â‰‡
\:mag_right:	ğŸ”
\^theta	á¶¿
\Succ	âª¼
\:clock330:	ğŸ•
\_schwa	â‚”
\ttf	ğš
\bsansEta	ğœ
\_0	â‚€
\dddot	âƒ›
\scri	ğ’¾
\:chart_with_upwards_trend:	ğŸ“ˆ
\:shirt:	ğŸ‘•
\implies	âŸ¹
\bfg	ğ 
\bfeta	ğ›ˆ
\:dancer:	ğŸ’ƒ
\dotminus	âˆ¸
\bscrN	ğ“
\oint	âˆ®
\circlearrowleft	â†º
\bscrE	ğ“”
\blackinwhitediamond	â—ˆ
\diamondleftblack	â¬–
\nHdownarrow	â‡Ÿ
\bbJ	ğ•
\:house:	ğŸ 
\:dog:	ğŸ¶
\diamondsuit	â™¢
\frakg	ğ”¤
\:hut:	ğŸ›–
\llbracket	âŸ¦
\UUparrow	âŸ°
\bfphi	ğ›Ÿ
\nsucc	âŠ
\:heart_decoration:	ğŸ’Ÿ
\:second_place_medal:	ğŸ¥ˆ
\succ	â‰»
\bfd	ğ
\bisansIota	ğ˜
\:beverage_box:	ğŸ§ƒ
\bbgamma	â„½
\isansv	ğ˜·
\biomicron	ğ„
\:black_nib:	âœ’
\bbT	ğ•‹
\scrC	ğ’
\pscrv	Ê‹
\bsansdelta	ğ³
\neovnwarrow	â¤±
\twoheadmapsto	â¤…
\langle	âŸ¨
\:zebra_face:	ğŸ¦“
\DownRightVectorBar	â¥—
\:cucumber:	ğŸ¥’
\:chopsticks:	ğŸ¥¢
\elsdot	âª—
\:non-potable_water:	ğŸš±
\biEta	ğœ¢
\:speaker:	ğŸ”ˆ
\xor	âŠ»
\rightangle	âˆŸ
\backsim	âˆ½
\:cyclone:	ğŸŒ€
\:musical_keyboard:	ğŸ¹
\:airplane:	âœˆ
\minhat	â©Ÿ
\isansJ	ğ˜‘
\bfmu	ğ›
\measeq	â‰
\:smiling_face_with_tear:	ğŸ¥²
\:registered:	Â®
\varphi	Ï†
\:person_climbing:	ğŸ§—
\:mag:	ğŸ”
\Tau	Î¤
\itAlpha	ğ›¢
\looparrowleft	â†«
\nVtwoheadrightarrow	â¤
\:arrow_double_up:	â«
\isansX	ğ˜Ÿ
\sansj	ğ—ƒ
\nsim	â‰
\ocirc	ÌŠ
\div	Ã·
\sansJ	ğ–©
\:ship:	ğŸš¢
\longmapsfrom	âŸ»
\squarehvfill	â–¦
\bfv	ğ¯
\leftrightharpoonupdown	â¥Š
\:tent:	â›º
\And	â©“
\bisansTheta	ğ—
\bbsum	â…€
\:fried_egg:	ğŸ³
\:monkey:	ğŸ’
\bscrC	ğ“’
\cancer	â™‹
\:skin-tone-5:	ğŸ¾
\lrblacktriangle	â—¢
\itBeta	ğ›£
\equalleftarrow	â­€
\:flashlight:	ğŸ”¦
\bscrg	ğ“°
\enclosetriangle	âƒ¤
\:star2:	ğŸŒŸ
\:nazar_amulet:	ğŸ§¿
\scrI	â„
\rightouterjoin	âŸ–
\bfrakZ	ğ–…
\twoheadmapsfrom	â¬¶
\:person_in_tuxedo:	ğŸ¤µ
\bsansalpha	ğ°
\bisansE	ğ™€
\binu	ğ‚
\itz	ğ‘§
\:clock8:	ğŸ•—
\^g	áµ
\scrO	ğ’ª
\biq	ğ’’
\bfOmicron	ğš¶
\bfrakI	ğ•´
\:wolf:	ğŸº
\leftwavearrow	â†œ
\:mechanical_arm:	ğŸ¦¾
\notlessgreater	â‰¸
\:package:	ğŸ“¦
\rightrightarrows	â‡‰
\:thong_sandal:	ğŸ©´
\:fireworks:	ğŸ†
\:hamburger:	ğŸ”
\:church:	â›ª
\3/5	â…—
\blackpointerright	â–º
\cdotp	Â·
\bfvarphi	ğ›—
\:rice_cracker:	ğŸ˜
\itOmicron	ğ›°
\biY	ğ’€
\italpha	ğ›¼
\:fountain:	â›²
\notbackslash	â€
\:sweet_potato:	ğŸ 
\blacktriangle	â–´
\mdblkcircle	âš«
\DownLeftRightVector	â¥
\ordmasculine	Âº
\frakI	â„‘
\:telescope:	ğŸ”­
\DownLeftTeeVector	â¥
\:joy_cat:	ğŸ˜¹
\:large_orange_circle:	ğŸŸ 
\^R	á´¿
\:baby:	ğŸ‘¶
\bfsix	ğŸ”
\rightarrowdiamond	â¤
\:volcano:	ğŸŒ‹
\bisanszeta	ğ¯
\bfraki	ğ–
\:notebook_with_decorative_cover:	ğŸ“”
\circlellquad	â—µ
\upuparrows	â‡ˆ
\:beaver:	ğŸ¦«
\planck	â„
\:vibration_mode:	ğŸ“³
\bsansRho	ğ¦
\:closed_lock_with_key:	ğŸ”
\:mask:	ğŸ˜·
\^downarrow	êœœ
\vDash	âŠ¨
\:arrows_clockwise:	ğŸ”ƒ
\:pretzel:	ğŸ¥¨
\varclubsuit	â™§
\bscrX	ğ“§
\sim	âˆ¼
\:arrow_right_hook:	â†ª
\:revolving_hearts:	ğŸ’
\RuleDelayed	â§´
\:cinema:	ğŸ¦
\scrJ	ğ’¥
\bfepsilon	ğ›œ
\rightarrowbsimilar	â­Œ
\:umbrella_with_rain_drops:	â˜”
\:potato:	ğŸ¥”
\:mammoth:	ğŸ¦£
\ggg	â‹™
\:angry:	ğŸ˜ 
\:heavy_minus_sign:	â–
\:mushroom:	ğŸ„
\:grapes:	ğŸ‡
\rightthreetimes	â‹Œ
\:moon:	ğŸŒ”
\bscrR	ğ“¡
\O	Ã˜
\:womans_clothes:	ğŸ‘š
\bbie	â…‡
\:guide_dog:	ğŸ¦®
\curlywedge	â‹
\itTau	ğ›µ
\itk	ğ‘˜
\underleftharpoondown	âƒ­
\smwhitestar	â­’
\circleulquad	â—´
\nprec	âŠ€
\_n	â‚™
\itphi	ğœ™
\leftrightarrows	â‡†
\biSigma	ğœ®
\eighthnote	â™ª
\:screwdriver:	ğŸª›
\bbrktbrk	â¶
\^(	â½
\:speedboat:	ğŸš¤
\1/2	Â½
\iint	âˆ¬
\nleqslant	â©½Ì¸
\leftrightarrowtriangle	â‡¿
\squarelrquad	â—²
\measanglerdtose	â¦ª
\eparsl	â§£
\nprecsim	â‰¾Ì¸
\btimes	â¨²
\bia	ğ’‚
\bisansLambda	ğš
\:post_office:	ğŸ£
\:large_orange_diamond:	ğŸ”¶
\bisansDelta	ğ“
\:flying_saucer:	ğŸ›¸
\bbw	ğ•¨
\:wine_glass:	ğŸ·
\bfrakP	ğ•»
\ordfeminine	Âª
\bsansY	ğ—¬
\:yarn:	ğŸ§¶
\sbrhr	Ë’
\Nwarrow	â‡–
\bsansmu	ğ»
\itlambda	ğœ†
\isansE	ğ˜Œ
\ae	Ã¦
\:left-facing_fist:	ğŸ¤›
\:credit_card:	ğŸ’³
\:goggles:	ğŸ¥½
\infty	âˆ
\eqgtr	â‹
\_=	â‚Œ
\:honey_pot:	ğŸ¯
\:sagittarius:	â™
\:compass:	ğŸ§­
\:yum:	ğŸ˜‹
\nvleftarrow	â‡·
\Swarrow	â‡™
\leftharpoonaccent	âƒ
\bbb	ğ•“
\:dash:	ğŸ’¨
\inversewhitecircle	â—™
\commaminus	â¨©
\bisansf	ğ™›
\bisansChi	ğ¦
\btdl	É¬
\:rotating_light:	ğŸš¨
\:railway_car:	ğŸšƒ
\:bow_and_arrow:	ğŸ¹
\smblksquare	â–ª
\lrcorner	âŒŸ
\bsansV	ğ—©
\birho	ğ†
\:arrow_left:	â¬…
\:herb:	ğŸŒ¿
\:womans_hat:	ğŸ‘’
\^M	á´¹
\simlE	âªŸ
\_8	â‚ˆ
\:cricket_bat_and_ball:	ğŸ
\bit	ğ’•
\cirfb	â—’
\bscrk	ğ“´
\:teddy_bear:	ğŸ§¸
\rightsquigarrow	â‡
\leftarrow	â†
\nVtwoheadleftarrowtail	â¬½
\revemptyset	â¦°
\bisansvarsigma	ğ»
\hkswarow	â¤¦
\:ledger:	ğŸ“’
\bisansq	ğ™¦
\:bridge_at_night:	ğŸŒ‰
\frakK	ğ”
\:pouting_cat:	ğŸ˜¾
\isansC	ğ˜Š
\:llama:	ğŸ¦™
\^B	á´®
\doublebarvee	â©¢
\circledwhitebullet	â¦¾
\itEta	ğ›¨
\bfzeta	ğ›‡
\isansG	ğ˜
\:city_sunset:	ğŸŒ†
\bih	ğ’‰
\measanglelutonw	â¦©
\:taxi:	ğŸš•
\upvDash	â««
\:arrow_heading_up:	â¤´
\neqsim	â‰‚Ì¸
\smwhtsquare	â–«
\leftarrowapprox	â­Š
\:oncoming_police_car:	ğŸš”
\Koppa	Ï
\itnu	ğœˆ
\gggnest	â«¸
\:whale2:	ğŸ‹
\angle	âˆ 
\scrT	ğ’¯
\itSigma	ğ›´
\:microbe:	ğŸ¦ 
\underrightarrow	âƒ¯
\:baggage_claim:	ğŸ›„
\:unamused:	ğŸ˜’
\lrtriangleeq	â§¡
\bscrL	ğ“›
\varointclockwise	âˆ²
\:waxing_crescent_moon:	ğŸŒ’
\twoheadrightarrowtail	â¤–
\bsansiota	ğ¸
\llblacktriangle	â—£
\_u	áµ¤
\ddotseq	â©·
\lltriangle	â—º
\bii	ğ’Š
\:bar_chart:	ğŸ“Š
\boxupcaret	â“
\approxeqq	â©°
\openbracketleft	âŸ¦
\^k	áµ
\:heart_eyes_cat:	ğŸ˜»
\isansK	ğ˜’
\simgtr	âª
\:dna:	ğŸ§¬
\bfGamma	ğšª
\barrightarrowdiamond	â¤ 
\triangleleft	â—
\bscrS	ğ“¢
\ttg	ğš
\:suspension_railway:	ğŸšŸ
\:mouse:	ğŸ­
\forkv	â«™
\updownarrowbar	â†¨
\upepsilon	Îµ
\:black_large_square:	â¬›
\bfdigamma	ğŸ‹
\pertenthousand	â€±
\precnsim	â‹¨
\profline	âŒ’
\itupsilon	ğœ
\reapos	â€›
\UpEquilibrium	â¥®
\:file_folder:	ğŸ“
\biC	ğ‘ª
\scrE	â„°
\:eggplant:	ğŸ†
\:goal_net:	ğŸ¥…
\aries	â™ˆ
\itMu	ğ›­
\Zbar	Æµ
\nleftarrow	â†š
\itvarepsilon	ğœ€
\mho	â„§
\bigwedge	â‹€
\benzenr	â£
\sanss	ğ—Œ
\:smiley:	ğŸ˜ƒ
\sinewave	âˆ¿
\:electric_plug:	ğŸ”Œ
\bbii	â…ˆ
\leftrightarrowcircle	â¥ˆ
\diamondbotblack	â¬™
\:adhesive_bandage:	ğŸ©¹
\curlyvee	â‹
\eth	Ã°
\itK	ğ¾
\bisansF	ğ™
\bsolhsub	âŸˆ
\:panda_face:	ğŸ¼
\lesseqqgtr	âª‹
\:plunger:	ğŸª 
\bbu	ğ•¦
\bsansf	ğ—³
\bsansj	ğ—·
\itI	ğ¼
\twocups	â©Š
\bisanspartial	ğŸƒ
\circlelrquad	â—¶
\lessdot	â‹–
\subsetplus	âª¿
\bfP	ğ
\:hippopotamus:	ğŸ¦›
\blackcircledtwodots	âš‰
\bfk	ğ¤
\ttseven	ğŸ½
\rsolbar	â§·
\sansa	ğ–º
\isansI	ğ˜
\:balloon:	ğŸˆ
\nVtwoheadrightarrowtail	â¤˜
\ttX	ğš‡
\ularc	â—œ
\_6	â‚†
\aa	Ã¥
\1/9	â…‘
\:sports_medal:	ğŸ…
\:elf:	ğŸ§
\:hotsprings:	â™¨
\:two_women_holding_hands:	ğŸ‘­
\Lsh	â†°
\:x:	âŒ
\itnabla	ğ›»
\trianglelefteq	âŠ´
\emptysetoarr	â¦³
\:mortar_board:	ğŸ“
\degree	Â°
\dicevi	âš…
\:oden:	ğŸ¢
\topbot	âŒ¶
\updownharpoonleftright	â¥
\bbone	ğŸ™
\fraka	ğ”
\:aries:	â™ˆ
\ddagger	â€¡
\bscrc	ğ“¬
\itvarpi	ğœ›
\itW	ğ‘Š
\:slightly_smiling_face:	ğŸ™‚
\:gemini:	â™Š
\:moneybag:	ğŸ’°
\circeq	â‰—
\Phi	Î¦
\guilsinglleft	â€¹
\bisansA	ğ˜¼
\AE	Ã†
\check	ÌŒ
\intx	â¨˜
\:vampire:	ğŸ§›
\bfNu	ğš´
\parallelogram	â–±
\bsansD	ğ——
\Dashv	â«¤
\sansb	ğ–»
\overbracket	â´
\bfchi	ğ›˜
\:watch:	âŒš
\:skin-tone-3:	ğŸ¼
\biI	ğ‘°
\:100:	ğŸ’¯
\:camel:	ğŸ«
\:stethoscope:	ğŸ©º
\bfSigma	ğšº
\:eyes:	ğŸ‘€
\bbg	ğ•˜
\Prec	âª»
\:u7121:	ğŸˆš
\subsetapprox	â«‰
\:kissing:	ğŸ˜—
\:banjo:	ğŸª•
\tricolon	â
\:handball:	ğŸ¤¾
\hookleftarrow	â†©
\:clown_face:	ğŸ¤¡
\LeftTriangleBar	â§
\:smoking:	ğŸš¬
\:traffic_light:	ğŸš¥
\bisansK	ğ™†
\bfDelta	ğš«
\wideangleup	â¦§
\csube	â«‘
\:calling:	ğŸ“²
\:sauropod:	ğŸ¦•
\natural	â™®
\niobar	â‹¾
\mp	âˆ“
\:bulb:	ğŸ’¡
\postalmark	ã€’
\NG	ÅŠ
\frakc	ğ” 
\biG	ğ‘®
\bfrakN	ğ•¹
\bisansT	ğ™
\:headphones:	ğŸ§
\tildelow	Ëœ
\dashrightharpoondown	â¥­
\:outbox_tray:	ğŸ“¤
\^H	á´´
\:salt:	ğŸ§‚
\:no_bell:	ğŸ”•
\gimel	â„·
\iiiint	â¨Œ
\bip	ğ’‘
\:expressionless:	ğŸ˜‘
\:cd:	ğŸ’¿
\twoheadleftarrowtail	â¬»
\ttq	ğšš
\smte	âª¬
\:mailbox_with_no_mail:	ğŸ“­
\:shushing_face:	ğŸ¤«
\whitepointerright	â–»
\:fast_forward:	â©
\nvLeftrightarrow	â¤„
\TH	Ã
\:fax:	ğŸ“ 
\revangleubar	â¦¥
\clwintegral	âˆ±
\sansthree	ğŸ¥
\circledbullet	â¦¿
\:school:	ğŸ«
\ttN	ğ™½
\bfdelta	ğ›…
\:ferris_wheel:	ğŸ¡
\:u6708:	ğŸˆ·
\hat	Ì‚
\:speak_no_evil:	ğŸ™Š
\vartheta	Ï‘
\bscrP	ğ“Ÿ
\Iota	Î™
\varlrtriangle	âŠ¿
\frakX	ğ”›
\:butterfly:	ğŸ¦‹
\itS	ğ‘†
\kernelcontraction	âˆ»
\ntriangleright	â‹«
\bisansEta	ğ–
\itvartheta	ğœ—
\trnt	Ê‡
\:heart_eyes:	ğŸ˜
\isansU	ğ˜œ
\enspace	â€‚
\:blowfish:	ğŸ¡
\bigcirc	â—‹
\:astonished:	ğŸ˜²
\itvarTheta	ğ›³
\sigma	Ïƒ
\bisansOmicron	ğ
\leftharpoonup	â†¼
\:racehorse:	ğŸ
\barleftarrowrightarrowbar	â†¹
\^w	Ê·
\bbA	ğ”¸
\:grey_question:	â”
\rightwhitearrow	â‡¨
\:boxing_glove:	ğŸ¥Š
\sqrtbottom	â·
\nVrightarrowtail	â¤•
\Leftrightarrow	â‡”
\rightharpoonsupdown	â¥¤
\lceil	âŒˆ
\:dromedary_camel:	ğŸª
\bfi	ğ¢
\bfrakH	ğ•³
\:ringed_planet:	ğŸª
\ne	â‰ 
\varsubsetneqq	âŠŠï¸€
\bullet	â€¢
\bfrakf	ğ–‹
\:arrow_forward:	â–¶
\:kissing_closed_eyes:	ğŸ˜š
\:moyai:	ğŸ—¿
\:horse:	ğŸ´
\:mailbox_closed:	ğŸ“ª
\:kiwifruit:	ğŸ¥
\itRho	ğ›²
\subedot	â«ƒ
\:duck:	ğŸ¦†
\:grinning:	ğŸ˜€
\dashleftharpoondown	â¥«
\ttd	ğš
\bsansM	ğ— 
\itkappa	ğœ…
\:white_heart:	ğŸ¤
\scrj	ğ’¿
\nsqsupseteq	â‹£
\:japanese_castle:	ğŸ¯
\bfrakA	ğ•¬
\:rainbow:	ğŸŒˆ
\:elephant:	ğŸ˜
\bfm	ğ¦
\bisansW	ğ™’
\:green_book:	ğŸ“—
\top	âŠ¤
\:heavy_division_sign:	â—
\:eyeglasses:	ğŸ‘“
\bbZ	â„¤
\itiota	ğœ„
\:bubble_tea:	ğŸ§‹
\rasp	Ê¼
\downharpoonright	â‡‚
\bsanssix	ğŸ²
\:person_in_steamy_room:	ğŸ§–
\:japan:	ğŸ—¾
\squarellblack	â¬•
\succsim	â‰¿
\dashV	â«£
\itzeta	ğœ
\emdash	â€”
\biA	ğ‘¨
\:haircut:	ğŸ’‡
\:diving_mask:	ğŸ¤¿
\:curling_stone:	ğŸ¥Œ
\scrM	â„³
\delta	Î´
\rfloor	âŒ‹
\eqslantless	âª•
\twoheaduparrow	â†Ÿ
\bisansM	ğ™ˆ
\^phi	áµ 
\bisansd	ğ™™
\^i	â±
\eqcolon	â‰•
\bfvarsigma	ğ›“
\bfrakM	ğ•¸
\:arrows_counterclockwise:	ğŸ”„
\nsubseteq	âŠˆ
\bisansomega	ğŸ‚
\wedge	âˆ§
\^N	á´º
\cdots	â‹¯
\:on:	ğŸ”›
\7/8	â…
\:ballet_shoes:	ğŸ©°
\spadesuit	â™ 
\bfChi	ğš¾
\:jack_o_lantern:	ğŸƒ
\:lips:	ğŸ‘„
\tildetrpl	â‰‹
\dbkarow	â¤
\:sunny:	â˜€
\DownArrowUpArrow	â‡µ
\intbar	â¨
\nasymp	â‰­
\npreceq	âª¯Ì¸
\isansM	ğ˜”
\:standing_person:	ğŸ§
\:rhinoceros:	ğŸ¦
\bfPhi	ğš½
\bbV	ğ•
\sansc	ğ–¼
\bfrakC	ğ•®
\isansB	ğ˜‰
\bisansPsi	ğ§
\squaretopblack	â¬’
\:copyright:	Â©
\:zzz:	ğŸ’¤
\:sleeping_accommodation:	ğŸ›Œ
\Vvert	â¦€
\:arrow_down:	â¬‡
\circledS	â“ˆ
\bbtwo	ğŸš
\boxdot	âŠ¡
\:dollar:	ğŸ’µ
\barovernorthwestarrow	â†¸
\mdwhtlozenge	â¬¨
\bsansE	ğ—˜
\bscrd	ğ“­
\:soccer:	âš½
\squarevfill	â–¥
\:construction_worker:	ğŸ‘·
\LeftVectorBar	â¥’
\_7	â‚‡
\itO	ğ‘‚
\:potable_water:	ğŸš°
\:robot_face:	ğŸ¤–
\smwhtcircle	â—¦
\rightarrowgtr	â­ƒ
\:arrow_down_small:	ğŸ”½
\:tropical_fish:	ğŸ 
\:fire_engine:	ğŸš’
\:large_brown_circle:	ğŸŸ¤
\ttfive	ğŸ»
\dsol	â§¶
\:repeat:	ğŸ”
\:unicorn_face:	ğŸ¦„
\itGamma	ğ›¤
\itg	ğ‘”
\odot	âŠ™
\bisansS	ğ™
\boxminus	âŠŸ
\:tired_face:	ğŸ˜«
\bfBeta	ğš©
\Pi	Î 
\^z	á¶»
\:petri_dish:	ğŸ§«
\gtrapprox	âª†
\lessgtr	â‰¶
\frakE	ğ”ˆ
\overleftrightarrow	âƒ¡
\bfrakX	ğ–ƒ
\:earth_americas:	ğŸŒ
\trademark	â„¢
\:first_quarter_moon_with_face:	ğŸŒ›
\:repeat_one:	ğŸ”‚
\bbfour	ğŸœ
\bscrY	ğ“¨
\:bird:	ğŸ¦
\rightarrowsupset	â­„
\:earth_asia:	ğŸŒ
\itu	ğ‘¢
\bio	ğ’
\:deaf_person:	ğŸ§
\eqcirc	â‰–
\quarternote	â™©
\measangleldtosw	â¦«
\frakJ	ğ”
\bsansvarepsilon	ğ´
\:game_die:	ğŸ²
\:clock630:	ğŸ•¡
\lgwhtsquare	â¬œ
\:ox:	ğŸ‚
\wedgeq	â‰™
\:page_with_curl:	ğŸ“ƒ
\hrectangleblack	â–¬
\hookrightarrow	â†ª
\supsetneq	âŠ‹
\nis	â‹¼
\5/6	â…š
\:police_car:	ğŸš“
\:badger:	ğŸ¦¡
\bbX	ğ•
\:clock1230:	ğŸ•§
\:santa:	ğŸ…
\succneqq	âª¶
\precneq	âª±
\diamondleftarrow	â¤
\bbY	ğ•
\bisansbeta	ğ«
\:cat:	ğŸ±
\:anguished:	ğŸ˜§
\bfTau	ğš»
\:station:	ğŸš‰
\:thought_balloon:	ğŸ’­
\bsansZ	ğ—­
\:loop:	â¿
\biphi	ğ“
\bfraka	ğ–†
\trnsa	É’
\^d	áµˆ
\Gamma	Î“
\preceq	âª¯
\bscrM	ğ“œ
\:tooth:	ğŸ¦·
\:bride_with_veil:	ğŸ‘°
\tosa	â¤©
\otimeslhrim	â¨´
\inglst	Ê–
\^u	áµ˜
\:anatomical_heart:	ğŸ«€
\:warning:	âš 
\ulblacktriangle	â—¤
\:first_quarter_moon:	ğŸŒ“
\bil	ğ’
\euro	â‚¬
\circ	âˆ˜
\bisansnabla	ğ©
\biTheta	ğœ£
\mdwhtsquare	â—»
\uplus	âŠ
\leftdbkarrow	â¤
\itb	ğ‘
\numero	â„–
\carriagereturn	â†µ
\gsiml	âª
\scrK	ğ’¦
\bsanso	ğ—¼
\:rat:	ğŸ€
\DJ	Ä
\:up:	ğŸ†™
\scrq	ğ“†
\:car:	ğŸš—
\:pig2:	ğŸ–
\bfOmega	ğ›€
\trny	Ê
\^3	Â³
\:globe_with_meridians:	ğŸŒ
\:black_circle:	âš«
\bfrakE	ğ•°
\:razor:	ğŸª’
\:ram:	ğŸ
\:third_place_medal:	ğŸ¥‰
\barcup	â©‚
\bftheta	ğ›‰
\:busstop:	ğŸš
\:boy:	ğŸ‘¦
\simrdots	â©«
\ttM	ğ™¼
\enclosediamond	âƒŸ
\bisansAlpha	ğ
\:gorilla:	ğŸ¦
\^5	âµ
\rightleftharpoonsup	â¥¨
\ltcir	â©¹
\varhexagonlrbonds	âŒ¬
\bir	ğ’“
\scrR	â„›
\:money_mouth_face:	ğŸ¤‘
\:video_camera:	ğŸ“¹
\:blue_heart:	ğŸ’™
\cap	âˆ©
\Kappa	Îš
\vdash	âŠ¢
\bib	ğ’ƒ
\because	âˆµ
\barcap	â©ƒ
\elinters	â§
\bfvarpi	ğ›¡
\Times	â¨¯
\:pizza:	ğŸ•
\:chestnut:	ğŸŒ°
\:baby_bottle:	ğŸ¼
\varniobar	â‹½
\:fuelpump:	â›½
\^iota	á¶¥
\biguplus	â¨„
\nVleftrightarrow	â‡¼
\itr	ğ‘Ÿ
\:hugging_face:	ğŸ¤—
\lrarc	â—
\frakQ	ğ””
\isansg	ğ˜¨
\setminus	âˆ–
\:point_right:	ğŸ‘‰
\doublepipe	Ç‚
\bsansone	ğŸ­
\:mosquito:	ğŸ¦Ÿ
\:relieved:	ğŸ˜Œ
\rightanglearc	âŠ¾
\blkvertoval	â¬®
\:person_with_blond_hair:	ğŸ‘±
\bisansPi	ğŸ
\longleftarrow	âŸµ
\:no_pedestrians:	ğŸš·
\downzigzagarrow	â†¯
\dj	Ä‘
\supedot	â«„
\biX	ğ‘¿
\scrd	ğ’¹
\ppprime	â€´
\bsansg	ğ—´
\bfomega	ğ›š
\:laughing:	ğŸ˜†
\notgreaterless	â‰¹
\:oncoming_taxi:	ğŸš–
\mdsmblksquare	â—¾
\:sunflower:	ğŸŒ»
\:handbag:	ğŸ‘œ
\:wind_chime:	ğŸ
\bisansxi	ğ·
\_5	â‚…
\measangleurtone	â¦¬
\bscrI	ğ“˜
\biy	ğ’š
\bisansz	ğ™¯
\sansQ	ğ–°
\:banana:	ğŸŒ
\:open_hands:	ğŸ‘
\:tada:	ğŸ‰
\rho	Ï
\:blueberries:	ğŸ«
\bscrK	ğ“š
\:luggage:	ğŸ§³
\:face_with_monocle:	ğŸ§
\itxi	ğœ‰
\bfpi	ğ›‘
\:popcorn:	ğŸ¿
\:martial_arts_uniform:	ğŸ¥‹
\bfrakh	ğ–
\emptysetobar	â¦±
\bsansPsi	ğ­
\leftthreetimes	â‹‹
\bfrakc	ğ–ˆ
\jupiter	â™ƒ
\tta	ğšŠ
\_a	â‚
\bumpeq	â‰
\:palm_tree:	ğŸŒ´
\bigblacktriangledown	â–¼
\:face_with_head_bandage:	ğŸ¤•
\dotplus	âˆ”
\opluslhrim	â¨­
\:busts_in_silhouette:	ğŸ‘¥
\:thinking_face:	ğŸ¤”
\mdwhtdiamond	â¬¦
\itT	ğ‘‡
\:bento:	ğŸ±
\:shark:	ğŸ¦ˆ
\diamondtopblack	â¬˜
\ttE	ğ™´
\:rewind:	âª
\bbj	ğ•›
\bfA	ğ€
\bsansa	ğ—®
\VDash	âŠ«
\upomicron	Î¿
\bscro	ğ“¸
\bsansT	ğ—§
\bisansC	ğ˜¾
\:princess:	ğŸ‘¸
\rsqhook	â«
\palh	Ì¡
\trnm	É¯
\:v:	âœŒ
\^6	â¶
\bfrakD	ğ•¯
\:clap:	ğŸ‘
\bscry	ğ”‚
\upsampi	Ï¡
\:arrow_upper_right:	â†—
\:black_heart:	ğŸ–¤
\itDelta	ğ›¥
\:sneezing_face:	ğŸ¤§
\geqqslant	â«º
\:card_index:	ğŸ“‡
\:pray:	ğŸ™
\bsansfour	ğŸ°
\^y	Ê¸
\binabla	ğœµ
\bisansupsilon	ğ¾
\:sheep:	ğŸ‘
\rtls	Ê‚
\bfPi	ğš·
\itQ	ğ‘„
\preccurlyeq	â‰¼
\nvrightarrowtail	â¤”
\:girl:	ğŸ‘§
\:tm:	â„¢
\:fries:	ğŸŸ
\bfE	ğ„
\otimes	âŠ—
\bfM	ğŒ
\bichi	ğŒ
\_t	â‚œ
\:atm:	ğŸ§
\vartriangleleft	âŠ²
\:raccoon:	ğŸ¦
\:bomb:	ğŸ’£
\NotSquareSuperset	âŠÌ¸
\:arrow_lower_right:	â†˜
\:full_moon_with_face:	ğŸŒ
\bsanszeta	ğµ
\ltlmr	É±
\Psi	Î¨
\squareurblack	â¬”
\scrb	ğ’·
\ominus	âŠ–
\bbm	ğ•
\grave	Ì€
\scrv	ğ“‹
\:whale:	ğŸ³
\:black_medium_small_square:	â—¾
\:one-piece_swimsuit:	ğŸ©±
\rightpentagonblack	â­“
\:triangular_flag_on_post:	ğŸš©
\bfone	ğŸ
\lesges	âª“
\:person_in_lotus_position:	ğŸ§˜
\bowtie	â‹ˆ
\bbU	ğ•Œ
\prod	âˆ
\bfraku	ğ–š
\biUpsilon	ğœ°
\lgblksquare	â¬›
\sansn	ğ—‡
\:do_not_litter:	ğŸš¯
\:flower_playing_cards:	ğŸ´
\:sunglasses:	ğŸ˜
\:books:	ğŸ“š
\:golf:	â›³
\downwhitearrow	â‡©
\big	ğ’ˆ
\:guardsman:	ğŸ’‚
\:people_hugging:	ğŸ«‚
\succcurlyeq	â‰½
\:symbols:	ğŸ”£
\bscrw	ğ”€
\scrW	ğ’²
\_)	â‚
\:prayer_beads:	ğŸ“¿
\not	Ì¸
\frako	ğ”¬
\bigoplus	â¨
\:negative_squared_cross_mark:	â
\circledequal	âŠœ
\rightanglemdot	â¦
\biAlpha	ğœœ
\:red_circle:	ğŸ”´
\neq	â‰ 
\ohm	â„¦
\:bust_in_silhouette:	ğŸ‘¤
\bsansd	ğ—±
\H	Ì‹
\bisanschi	ğŸ€
\:goat:	ğŸ
\2/3	â…”
\:superhero:	ğŸ¦¸
\upstigma	Ï›
\digamma	Ï
\bsanseta	ğ¶
\sansV	ğ–µ
\:arrow_right:	â¡
\:lemon:	ğŸ‹
\bfrakr	ğ–—
\bfseven	ğŸ•
\:imp:	ğŸ‘¿
\biT	ğ‘»
\divideontimes	â‹‡
\:sleepy:	ğŸ˜ª
\:u7533:	ğŸˆ¸
\bbG	ğ”¾
\disin	â‹²
\gsime	âª
\NotNestedGreaterGreater	âª¢Ì¸
\jmath	È·
\lgwhtcircle	â—¯
\blackinwhitesquare	â–£
\bfraky	ğ–
\diagdown	â•²
\doteq	â‰
\bsansgamma	ğ²
\:arrow_upper_left:	â†–
\bigslopedwedge	â©˜
\supsup	â«–
\upint	â¨›
\:tv:	ğŸ“º
\:garlic:	ğŸ§„
\:secret:	ãŠ™
\bscrT	ğ“£
\bigcup	â‹ƒ
\simeq	â‰ƒ
\vysmblkcircle	âˆ™
\:foot:	ğŸ¦¶
\gvertneqq	â‰©ï¸€
\bsansr	ğ—¿
\:kaaba:	ğŸ•‹
\bisanstheta	ğ±
\:trumpet:	ğŸº
\bfrakp	ğ–•
\triangleleftblack	â—­
\bfT	ğ“
\varhexagonblack	â¬¢
\:strawberry:	ğŸ“
\:green_salad:	ğŸ¥—
\llarc	â—Ÿ
\bscri	ğ“²
\iff	âŸº
\isansm	ğ˜®
\lllnest	â«·
\nand	âŠ¼
\backprime	â€µ
\lambda	Î»
\starequal	â‰›
\blanksymbol	â¢
\triangledown	â–¿
\:large_red_square:	ğŸŸ¥
\closedvarcap	â©
\itd	ğ‘‘
\iteta	ğœ‚
\bfrakb	ğ–‡
\pbgam	É¤
\isindot	â‹µ
\blacktriangleleft	â—€
\eqqless	âª™
\bisansb	ğ™—
\bfrakl	ğ–‘
\:manual_wheelchair:	ğŸ¦½
\cong	â‰…
\:mouse_trap:	ğŸª¤
\varsupsetneq	âŠ‹ï¸€
\:lotion_bottle:	ğŸ§´
\:gem:	ğŸ’
\pppprime	â—
\:love_letter:	ğŸ’Œ
\bisanss	ğ™¨
\low	Ë•
\eqvparsl	â§¥
\medwhitestar	â­
\isansb	ğ˜£
\:skin-tone-4:	ğŸ½
\measangleultonw	â¦­
\bigsqcap	â¨…
\supsub	â«”
\sun	â˜¼
\:point_up:	â˜
\lazysinv	âˆ¾
\rh	Ì¢
\asteq	â©®
\itV	ğ‘‰
\:mega:	ğŸ“£
\:rose:	ğŸŒ¹
\vysmwhtsquare	â¬
\bsansbeta	ğ±
\biE	ğ‘¬
\:water_polo:	ğŸ¤½
\:arrow_up_down:	â†•
\:ophiuchus:	â›
\bisansGamma	ğ’
\:tiger2:	ğŸ…
\:+1:	ğŸ‘
\:leafy_green:	ğŸ¥¬
\:worm:	ğŸª±
\sqcap	âŠ“
\:department_store:	ğŸ¬
\:fork_and_knife:	ğŸ´
\succnapprox	âªº
\bbsix	ğŸ
\bfW	ğ–
\:helicopter:	ğŸš
\bbe	ğ•–
\^s	Ë¢
\isansf	ğ˜§
\ttL	ğ™»
\:fish:	ğŸŸ
\^9	â¹
\:cold_face:	ğŸ¥¶
\approxeq	â‰Š
\_h	â‚•
\dlcorn	â£
\:large_blue_square:	ğŸŸ¦
\rightarrowbar	â‡¥
\:snail:	ğŸŒ
\hermitconjmatrix	âŠ¹
\:ticket:	ğŸ«
\notslash	âŒ¿
\:trolleybus:	ğŸš
\rightarrow	â†’
\bisigma	ğˆ
\frakB	ğ”…
\rightpentagon	â­”
\Mapsfrom	â¤†
\:recycle:	â™»
\circletophalfblack	â—“
\1/3	â…“
\:bus:	ğŸšŒ
\:deciduous_tree:	ğŸŒ³
\_l	â‚—
\viewdata	âŒ—
\overbar	Ì…
\ttv	ğšŸ
\diamondleftarrowbar	â¤Ÿ
\bisansO	ğ™Š
\zeta	Î¶
\:heavy_plus_sign:	â•
\:crying_cat_face:	ğŸ˜¿
\:boar:	ğŸ—
\bbPi	â„¿
\:coffee:	â˜•
\itv	ğ‘£
\:briefcase:	ğŸ’¼
\:cherry_blossom:	ğŸŒ¸
\^O	á´¼
\lpargt	â¦ 
\bscrm	ğ“¶
\:two_men_holding_hands:	ğŸ‘¬
\^7	â·
\:sa:	ğŸˆ‚
\candra	Ì
\triangleplus	â¨¹
\:diamonds:	â™¦
\:notes:	ğŸ¶
\bbI	ğ•€
\:skin-tone-6:	ğŸ¿
\sansP	ğ–¯
\bffour	ğŸ’
\tteight	ğŸ¾
\bisanslambda	ğ´
\yogh	Ê’
\:stuck_out_tongue_winking_eye:	ğŸ˜œ
\bsansi	ğ—¶
\:two_hearts:	ğŸ’•
\glst	Ê”
\annuity	âƒ§
\:zap:	âš¡
\sanssix	ğŸ¨
\blackrighthalfcircle	â——
\:mount_fuji:	ğŸ—»
\minusdot	â¨ª
\revangle	â¦£
\:capital_abcd:	ğŸ” 
\gtrdot	â‹—
\circledR	Â®
\nVdash	âŠ®
\veeodot	â©’
\biupsilon	ğŠ
\:back:	ğŸ”™
\nsime	â‰„
\:penguin:	ğŸ§
\NotRightTriangleBar	â§Ì¸
\:couplekiss:	ğŸ’
\Digamma	Ïœ
\bfC	ğ‚
\verti	ËŒ
\Rrightarrow	â‡›
\eqless	â‹œ
\itsigma	ğœ
\toea	â¤¨
\itf	ğ‘“
\:no_mobile_phones:	ğŸ“µ
\frakd	ğ”¡
\seovnearrow	â¤­
\openo	É”
\gneqq	â‰©
\:poodle:	ğŸ©
\downvDash	â«ª
\dingasterisk	âœ½
\:school_satchel:	ğŸ’
\:alien:	ğŸ‘½
\:minibus:	ğŸš
\1/4	Â¼
\rceil	âŒ‰
\lesdoto	âª
\bisansphi	ğŸ‡
\leftarrowonoplus	â¬²
\bivarphi	ğ‹
\:large_blue_circle:	ğŸ”µ
\itbeta	ğ›½
\upin	âŸ’
\longrightsquigarrow	âŸ¿
\gtcir	â©º
\_e	â‚‘
\:construction:	ğŸš§
\varkappa	Ï°
\sansd	ğ–½
\cbrt	âˆ›
\biF	ğ‘­
\bscru	ğ“¾
\biOmicron	ğœª
\:stew:	ğŸ²
\:bathtub:	ğŸ›
\:poultry_leg:	ğŸ—
\_(	â‚
\:orange_book:	ğŸ“™
\fhr	É¾
\:fist:	âœŠ
\:basketball:	ğŸ€
\sansU	ğ–´
\bisansN	ğ™‰
\blackcircleulquadwhite	â—•
\:o2:	ğŸ…¾
\^!	êœ
\:child:	ğŸ§’
\bieta	ğœ¼
\oslash	âŠ˜
\itZeta	ğ›§
\itEpsilon	ğ›¦
\:hotdog:	ğŸŒ­
\sansp	ğ—‰
\itY	ğ‘Œ
\bsanszero	ğŸ¬
\:mountain_cableway:	ğŸš 
\sblhr	Ë“
\simminussim	â©¬
\bsansA	ğ—”
\join	â¨
\bot	âŠ¥
\:large_yellow_circle:	ğŸŸ¡
\:tram:	ğŸšŠ
\gnsim	â‹§
\Chi	Î§
\biO	ğ‘¶
\sqfl	â—§
\:pound:	ğŸ’·
\scrX	ğ’³
\:radio_button:	ğŸ”˜
\:military_helmet:	ğŸª–
\_m	â‚˜
\models	âŠ§
\:eight_spoked_asterisk:	âœ³
\lneqq	â‰¨
\trnrl	Éº
\:muscle:	ğŸ’ª
\bbx	ğ•©
\:bikini:	ğŸ‘™
\:stars:	ğŸŒ 
\:basket:	ğŸ§º
\ttF	ğ™µ
\:glass_of_milk:	ğŸ¥›
\mlcp	â«›
\leftsquigarrow	â‡œ
\:oncoming_automobile:	ğŸš˜
\1/8	â…›
\:metro:	ğŸš‡
\blacktriangleright	â–¶
\^4	â´
\pitchfork	â‹”
\bisanskappa	ğ³
\:shallow_pan_of_food:	ğŸ¥˜
\blockqtrshaded	â–‘
\bsansPi	ğ¥
\sansseven	ğŸ©
\leftarrowbsimilar	â­‹
\:cricket:	ğŸ¦—
\sqsubseteq	âŠ‘
\Updownarrow	â‡•
\:clock9:	ğŸ•˜
\Theta	Î˜
\:cake:	ğŸ°
\rightmoon	â˜½
\bscrV	ğ“¥
\ttc	ğšŒ
\:chicken:	ğŸ”
\:white_circle:	âšª
\fltns	â¥
\bbN	â„•
\smile	âŒ£
\0/3	â†‰
\rdq	â€
\bitau	ğ‰
\lq	â€˜
\mapsfrom	â†¤
\perp	âŸ‚
\bitheta	ğœ½
\:izakaya_lantern:	ğŸ®
\biS	ğ‘º
\timesbar	â¨±
\bik	ğ’Œ
\bigtimes	â¨‰
\:mage:	ğŸ§™
\:safety_pin:	ğŸ§·
\bsansI	ğ—œ
\leftharpoondown	â†½
\alpha	Î±
\between	â‰¬
\frown	âŒ¢
\RoundImplies	â¥°
\blockthreeqtrshaded	â–“
\:white_large_square:	â¬œ
\bsansthree	ğŸ¯
\:candy:	ğŸ¬
\bfvarkappa	ğ›
\:chair:	ğŸª‘
\fraki	ğ”¦
\tilde	Ìƒ
\upNu	Î
\sansg	ğ—€
\bisansh	ğ™
\:facepunch:	ğŸ‘Š
\itimath	ğš¤
\:womens:	ğŸšº
\rightleftarrows	â‡„
\:syringe:	ğŸ’‰
\sumint	â¨‹
\fdiagovnearrow	â¤¯
\plussubtwo	â¨§
\bfQ	ğ
\biw	ğ’˜
\bfo	ğ¨
\nleftrightarrow	â†®
\scrs	ğ“ˆ
\:bacon:	ğŸ¥“
\Im	â„‘
\bsansK	ğ—
\:merperson:	ğŸ§œ
\bisansvarrho	ğŸˆ
\whtvertoval	â¬¯
\:window:	ğŸªŸ
\smallin	âˆŠ
\:corn:	ğŸŒ½
\ttW	ğš†
\bfrakV	ğ–
\smallblacktriangleright	â–¸
\:clipboard:	ğŸ“‹
\leftwhitearrow	â‡¦
\bsansChi	ğ¬
\ge	â‰¥
\rttrnr	É»
\squareulquad	â—°
\amalg	â¨¿
\biKappa	ğœ¥
\turnangle	â¦¢
\:kiss:	ğŸ’‹
\wideutilde	Ì°
\trianglerightblack	â—®
\bfr	ğ«
\frakM	ğ”
\uparrow	â†‘
\nvleftarrowtail	â¬¹
\:magic_wand:	ğŸª„
\_4	â‚„
\biXi	ğœ©
\bisansvarpi	ğŸ‰
\plussim	â¨¦
\rvboxline	â¹
\bfnu	ğ›
\:blue_book:	ğŸ“˜
\sterling	Â£
\bscrs	ğ“¼
\frakU	ğ”˜
\nVDash	âŠ¯
\nvRightarrow	â¤ƒ
\downharpoonsleftright	â¥¥
\yen	Â¥
\bbB	ğ”¹
\isanss	ğ˜´
\theta	Î¸
\bfZ	ğ™
\:swimmer:	ğŸŠ
\bftau	ğ›•
\male	â™‚
\:chart:	ğŸ’¹
\LeftUpVectorBar	â¥˜
\:crab:	ğŸ¦€
\1/	â…Ÿ
\bfrakm	ğ–’
\bigslopedvee	â©—
\blocklowhalf	â–„
\forks	â«œ
\Alpha	Î‘
\:footprints:	ğŸ‘£
\scrc	ğ’¸
\:fire:	ğŸ”¥
\bbK	ğ•‚
\psi	Ïˆ
\:video_game:	ğŸ®
\gesdotol	âª„
\fraks	ğ”°
\botsemicircle	â—¡
\:man_dancing:	ğŸ•º
\updownharpoonrightleft	â¥Œ
\bisansj	ğ™Ÿ
\Sampi	Ï 
\olessthan	â§€
\star	â‹†
\overleftarrow	âƒ–
\bsanseight	ğŸ´
\Downarrow	â‡“
\:clock2:	ğŸ•‘
\bfS	ğ’
\:clock7:	ğŸ•–
\:knot:	ğŸª¢
\^J	á´¶
\Longmapsto	âŸ¾
\gesdot	âª€
\bsansz	ğ˜‡
\itrho	ğœŒ
\rtld	É–
\NotLessLess	â‰ªÌ¸
\:brain:	ğŸ§ 
\bsansseven	ğŸ³
\sbbrg	Ìª
\visiblespace	â£
\:vs:	ğŸ†š
\glE	âª’
\squarebotblack	â¬“
\gtreqless	â‹›
\dottimes	â¨°
\twocaps	â©‹
\:sled:	ğŸ›·
\biB	ğ‘©
\frakN	ğ”‘
\bsansupsilon	ğ„
\:feet:	ğŸ¾
\Elroang	â¦†
\forksnot	â«
\asteraccent	âƒ°
\leftharpoonupdash	â¥ª
\:pinching_hand:	ğŸ¤
\^D	á´°
\Angle	â¦œ
\:cow2:	ğŸ„
\wedgemidvert	â©š
\:champagne:	ğŸ¾
\dicev	âš„
\ReverseUpEquilibrium	â¥¯
\2/5	â…–
\_3	â‚ƒ
\bisansH	ğ™ƒ
\bisansL	ğ™‡
\:hotel:	ğŸ¨
\scrk	ğ“€
\:smile_cat:	ğŸ˜¸
\bsansW	ğ—ª
\varisins	â‹³
\rightleftharpoons	â‡Œ
\blacksmiley	â˜»
\ddfnc	â¦™
\bfgamma	ğ›„
\:tangerine:	ğŸŠ
\isansP	ğ˜—
\scrg	â„Š
\:birthday:	ğŸ‚
\ttB	ğ™±
\isanse	ğ˜¦
\rais	Ë”
\frakk	ğ”¨
\nVtwoheadleftarrow	â¬µ
\ttI	ğ™¸
\checkmark	âœ“
\bbh	ğ•™
\itA	ğ´
\bfrakn	ğ–“
\:parrot:	ğŸ¦œ
\rl	É¼
\leftarrowless	â¥·
\:abc:	ğŸ”¤
\bisansXi	ğ
\nsubseteqq	â«…Ì¸
\bfrho	ğ›’
\sansZ	ğ–¹
\bbiD	â……
\:large_blue_diamond:	ğŸ”·
\scrn	ğ“ƒ
\isansd	ğ˜¥
\:firecracker:	ğŸ§¨
\:bat:	ğŸ¦‡
\:wheelchair:	â™¿
\obar	âŒ½
\:free:	ğŸ†“
\:motorized_wheelchair:	ğŸ¦¼
\3/4	Â¾
\prurel	âŠ°
\rvbull	â—˜
\bsansk	ğ—¸
\:waffle:	ğŸ§‡
\verts	Ëˆ
\perthousand	â€°
\bfK	ğŠ
\:ok:	ğŸ†—
\scrY	ğ’´
\scrt	ğ“‰
\isansy	ğ˜º
\Vert	â€–
\bsansDelta	ğ™
\:persevere:	ğŸ˜£
\:pineapple:	ğŸ
\:tea:	ğŸµ
\bivarTheta	ğœ­
\:crossed_flags:	ğŸŒ
\ocommatopright	Ì•
\bfLambda	ğš²
\_k	â‚–
\:low_brightness:	ğŸ”…
\perspcorrespond	â©
\twoheadrightarrow	â† 
\plustrif	â¨¨
\biV	ğ‘½
\:smile:	ğŸ˜„
\bsanslambda	ğº
\bfpartial	ğ››
\c	Ì§
\blackpointerleft	â—„
\:hiking_boot:	ğŸ¥¾
\upwhitearrow	â‡§
\bsansvarpi	ğ
\bft	ğ­
\:arrow_double_down:	â¬
\sqrt	âˆš
\:hourglass:	âŒ›
\plusdot	â¨¥
\bigodot	â¨€
\bsimilarleftarrow	â­
\varTheta	Ï´
\bbQ	â„š
\bfxi	ğ›
\biLambda	ğœ¦
\^m	áµ
\:lying_face:	ğŸ¤¥
\:clock430:	ğŸ•Ÿ
\ltcc	âª¦
\medblackstar	â­‘
\itU	ğ‘ˆ
\:vhs:	ğŸ“¼
\Rightarrow	â‡’
\bsansvarkappa	ğŒ
\:congratulations:	ãŠ—
\:billed_cap:	ğŸ§¢
\:shorts:	ğŸ©³
\scra	ğ’¶
\itp	ğ‘
\:black_medium_square:	â—¼
\aleph	â„µ
\bsansnabla	ğ¯
\:violin:	ğŸ»
\xi	Î¾
\lessapprox	âª…
\:anchor:	âš“
\bisansnu	ğ¶
\to	â†’
\itPsi	ğ›¹
\tti	ğš’
\:purse:	ğŸ‘›
\:orangutan:	ğŸ¦§
\:toilet:	ğŸš½
\^o	áµ’
\upoldkoppa	Ï™
\scrN	ğ’©
\:joy:	ğŸ˜‚
\:hook:	ğŸª
\pm	Â±
\bfXi	ğšµ
\prec	â‰º
\disjquant	â¨ˆ
\:gift:	ğŸ
\:bell_pepper:	ğŸ«‘
\:ear:	ğŸ‘‚
\:arrow_heading_down:	â¤µ
\measuredangleleft	â¦›
\bsansS	ğ—¦
\bfJ	ğ‰
\bbv	ğ•§
\:egg:	ğŸ¥š
\bisansmu	ğµ
\:shell:	ğŸš
\:shopping_trolley:	ğŸ›’
\:zombie:	ğŸ§Ÿ
\downharpoonleft	â‡ƒ
\phi	Ï•
\:oyster:	ğŸ¦ª
\:clock130:	ğŸ•œ
\lozenge	â—Š
\circledparallel	â¦·
\nvleftrightarrow	â‡¹
\itF	ğ¹
\ito	ğ‘œ
\itUpsilon	ğ›¶
\:left_luggage:	ğŸ›…
\invv	ÊŒ
\subseteqq	â«…
\blockfull	â–ˆ
\:fox_face:	ğŸ¦Š
\:christmas_tree:	ğŸ„
\:pear:	ğŸ
\widebridgeabove	âƒ©
\:angel:	ğŸ‘¼
\:newspaper:	ğŸ“°
\:horse_racing:	ğŸ‡
\sphericalangleup	â¦¡
\bfb	ğ›
\bisansTau	ğ£
\bsansAlpha	ğ–
\:point_up_2:	ğŸ‘†
\heartsuit	â™¡
\bsansH	ğ—›
\:vertical_traffic_light:	ğŸš¦
\circledstar	âœª
\subset	âŠ‚
\bsanstau	ğƒ
\:heavy_multiplication_x:	âœ–
\venus	â™€
\thinspace	â€‰
\fallingdotseq	â‰’
\partialmeetcontraction	âª£
\:slightly_frowning_face:	ğŸ™
\squarecrossfill	â–©
\:snowman_without_snow:	â›„
\frakC	â„­
\approx	â‰ˆ
\bscrO	ğ“
\ntriangleleft	â‹ª
\barvee	âŠ½
\invwhitelowerhalfcircle	â—›
\:long_drum:	ğŸª˜
\partial	âˆ‚
\pluto	â™‡
\wedgedoublebar	â© 
\eqqslantgtr	âªœ
\kappa	Îº
\:headstone:	ğŸª¦
\:u5272:	ğŸˆ¹
\:hamster:	ğŸ¹
\mdsmwhtsquare	â—½
\frakx	ğ”µ
\whthorzoval	â¬­
\bisansvarepsilon	ğ®
\blocklefthalf	â–Œ
\sansq	ğ—Š
\Vvdash	âŠª
\:juggling:	ğŸ¤¹
\sansE	ğ–¤
\:surfer:	ğŸ„
\:bearded_person:	ğŸ§”
\questeq	â‰Ÿ
\wp	â„˜
\:gloves:	ğŸ§¤
\bfomicron	ğ›
\:door:	ğŸšª
\:clock11:	ğŸ•š
\:large_yellow_square:	ğŸŸ¨
\bisansgamma	ğ¬
\:clapper:	ğŸ¬
\ttO	ğ™¾
\:face_with_symbols_on_mouth:	ğŸ¤¬
\bfrakS	ğ•¾
\:radio:	ğŸ“»
\:auto_rickshaw:	ğŸ›º
\NotGreaterGreater	â‰«Ì¸
\bsansB	ğ—•
\bsansX	ğ—«
\:bookmark_tabs:	ğŸ“‘
\LLeftarrow	â­…
\trnmlr	É°
\:giraffe_face:	ğŸ¦’
\:hand:	âœ‹
\ttz	ğš£
\:rowboat:	ğŸš£
\:peacock:	ğŸ¦š
\:large_orange_square:	ğŸŸ§
\intcup	â¨š
\lneq	âª‡
\^e	áµ‰
\:hot_face:	ğŸ¥µ
\:rock:	ğŸª¨
\^delta	áµŸ
\varheartsuit	â™¥
\:saxophone:	ğŸ·
\bigstar	â˜…
\:breast-feeding:	ğŸ¤±
\smblkdiamond	â¬©
\tdcol	â«¶
\ngeq	â‰±
\supseteq	âŠ‡
\bisansG	ğ™‚
\:information_desk_person:	ğŸ’
\:page_facing_up:	ğŸ“„
\itXi	ğ›¯
\varrho	Ï±
\neptune	â™†
\lgblkcircle	â¬¤
\:book:	ğŸ“–
\dots	â€¦
\longleftrightarrow	âŸ·
\scrH	â„‹
\:beer:	ğŸº
\:leg:	ğŸ¦µ
\:anger:	ğŸ’¢
\bipsi	ğ
\:airplane_departure:	ğŸ›«
\:clock230:	ğŸ•
\isins	â‹´
\bsansIota	ğ
\:melon:	ğŸˆ
\:red_envelope:	ğŸ§§
\gescc	âª©
\threedangle	âŸ€
\:blossom:	ğŸŒ¼
\sansB	ğ–¡
\_o	â‚’
\biTau	ğœ¯
\:u6709:	ğŸˆ¶
\diagup	â•±
\:gun:	ğŸ”«
\:small_red_triangle:	ğŸ”º
\isansi	ğ˜ª
\rightwavearrow	â†
\nexists	âˆ„
\nVleftarrowtail	â¬º
\:kite:	ğŸª
\bsansZeta	ğ›
\underbrace	âŸ
\circleurquadblack	â—”
\:ice_cream:	ğŸ¨
\:purple_heart:	ğŸ’œ
\boxplus	âŠ
\:water_buffalo:	ğŸƒ
\^x	Ë£
\:clock930:	ğŸ•¤
\oplusrhrim	â¨®
\biChi	ğœ²
\^uparrow	êœ›
\ultriangle	â—¸
\bsansG	ğ—š
\OE	Å’
\capricornus	â™‘
\underbracket	âµ
\bfN	ğ
\bsanstwo	ğŸ®
\:ant:	ğŸœ
\:heartbeat:	ğŸ’“
\:olive:	ğŸ«’
\:kneeling_person:	ğŸ§
\:couple:	ğŸ‘«
\itM	ğ‘€
\bsansv	ğ˜ƒ
\:abcd:	ğŸ”¡
\:lipstick:	ğŸ’„
\bscrH	ğ“—
\bfrakk	ğ–
\:rabbit2:	ğŸ‡
\^0	â°
\enclosecircle	âƒ
\bscrQ	ğ“ 
\:football:	ğŸˆ
\modtwosum	â¨Š
\:ballot_box_with_check:	â˜‘
\:falafel:	ğŸ§†
\biiota	ğœ¾
\^alpha	áµ…
\measanglerutone	â¦¨
\:hearts:	â™¥
\sansLmirrored	â…ƒ
\nvrightarrow	â‡¸
\pes	â‚§
\:toolbox:	ğŸ§°
\sanstwo	ğŸ¤
\imath	Ä±
\biZeta	ğœ¡
\:face_vomiting:	ğŸ¤®
\frakL	ğ”
\bsansxi	ğ½
\scrU	ğ’°
\bfiota	ğ›Š
\:guitar:	ğŸ¸
\:small_red_triangle_down:	ğŸ”»
\boxbar	â—«
\Ldsh	â†²
\bisansalpha	ğª
\angdnr	â¦Ÿ
\:email:	âœ‰
\Xi	Î
\:exploding_head:	ğŸ¤¯
\:dodo:	ğŸ¦¤
\veebar	âŠ»
\nsuccsim	â‰¿Ì¸
\bsansN	ğ—¡
\bisansy	ğ™®
\tto	ğš˜
\bsanspi	ğ¿
\frakr	ğ”¯
\leftdasharrow	â‡ 
\bfrakQ	ğ•¼
\:flushed:	ğŸ˜³
\triangletimes	â¨»
\:croissant:	ğŸ¥
\:ear_with_hearing_aid:	ğŸ¦»
\closedvarcup	â©Œ
\:pie:	ğŸ¥§
\bbH	â„
\:hospital:	ğŸ¥
\_gamma	áµ§
\lrtriangle	â—¿
\:point_down:	ğŸ‘‡
\:owl:	ğŸ¦‰
\congdot	â©­
\:ribbon:	ğŸ€
\minusrdots	â¨¬
\bscrf	ğ“¯
\bfbeta	ğ›ƒ
\bsansF	ğ—™
\eqqplus	â©±
\bisansp	ğ™¥
\barleftarrow	â‡¤
\bscrr	ğ“»
\ttsix	ğŸ¼
\isansN	ğ˜•
\itLambda	ğ›¬
\equivDD	â©¸
\bbthree	ğŸ›
\biM	ğ‘´
\:crystal_ball:	ğŸ”®
\:european_castle:	ğŸ°
\Finv	â„²
\Top	â«ª
\:clubs:	â™£
\:rugby_football:	ğŸ‰
\itw	ğ‘¤
\:smirk:	ğŸ˜
\:u5408:	ğŸˆ´
\:raised_hands:	ğŸ™Œ
\bsanst	ğ˜
\:calendar:	ğŸ“†
\:lock:	ğŸ”’
\bsansnu	ğ¼
\smalltriangleleft	â—ƒ
\isansO	ğ˜–
\bsansL	ğ—Ÿ
\nLeftarrow	â‡
\bie	ğ’†
\:ocean:	ğŸŒŠ
\rightleftharpoonsdown	â¥©
\acute	Ì
\bsansl	ğ—¹
\Nearrow	â‡—
\biu	ğ’–
\:nail_care:	ğŸ’…
\bigtriangledown	â–½
\:the_horns:	ğŸ¤˜
\Longleftarrow	âŸ¸
\square	â–¡
\sansh	ğ—
\circledrightdot	âš†
\:kissing_smiling_eyes:	ğŸ˜™
\:baby_symbol:	ğŸš¼
\isanso	ğ˜°
\Longmapsfrom	âŸ½
\:large_green_square:	ğŸŸ©
\Yup	â…„
\:sari:	ğŸ¥»
\scrZ	ğ’µ
\itvarrho	ğœš
\clubsuit	â™£
\:clock530:	ğŸ• 
\Stigma	Ïš
\5/8	â…
\:hocho:	ğŸ”ª
\:pouch:	ğŸ‘
\bsansC	ğ—–
\downdownarrows	â‡Š
\^f	á¶ 
\lowint	â¨œ
\emptyset	âˆ…
\sansM	ğ–¬
\bsansp	ğ—½
\blacklozenge	â§«
\itvarphi	ğœ‘
\:blush:	ğŸ˜Š
\bisansn	ğ™£
\isansV	ğ˜
\ttp	ğš™
\:high_heel:	ğŸ‘ 
\:wedding:	ğŸ’’
\beth	â„¶
\:wavy_dash:	ã€°
\itj	ğ‘—
\:face_with_raised_eyebrow:	ğŸ¤¨
\:train2:	ğŸš†
\itpi	ğœ‹
\bfrakt	ğ–™
\sansG	ğ–¦
\_-	â‚‹
\sqsupsetneq	â‹¥
\bfsigma	ğ›”
\:computer:	ğŸ’»
\turnk	Ê
\bigcupdot	â¨ƒ
\itE	ğ¸
\ith	â„
\iiint	âˆ­
\threeunderdot	âƒ¨
\:euro:	ğŸ’¶
\:frog:	ğŸ¸
\:axe:	ğŸª“
\frakF	ğ”‰
\lvboxline	â¸
\:ng:	ğŸ†–
\midbarwedge	â©œ
\sqcup	âŠ”
\bikappa	ğœ¿
\Longrightarrow	âŸ¹
\subsetneq	âŠŠ
\ovhook	Ì‰
\dagger	â€ 
\:meat_on_bone:	ğŸ–
\supsetdot	âª¾
\frakf	ğ”£
\bbf	ğ•—
\:put_litter_in_its_place:	ğŸš®
\itP	ğ‘ƒ
\:u6307:	ğŸˆ¯
\:full_moon:	ğŸŒ•
\:blue_car:	ğŸš™
\:leo:	â™Œ
\Sqcup	â©
\isansa	ğ˜¢
\:crossed_fingers:	ğŸ¤
\:pregnant_woman:	ğŸ¤°
\DownRightTeeVector	â¥Ÿ
\supsetapprox	â«Š
\ttP	ğ™¿
\:b:	ğŸ…±
\allequal	â‰Œ
\bfV	ğ•
\del	âˆ‡
\bbC	â„‚
\female	â™€
\:face_with_thermometer:	ğŸ¤’
\bsansc	ğ—°
\bfnabla	ğ›
\^T	áµ€
\capdot	â©€
\ntrianglerighteq	â‹­
\nni	âˆŒ
\:pensive:	ğŸ˜”
\:dolls:	ğŸ
\saturn	â™„
\bsansBeta	ğ—
\curlyeqsucc	â‹Ÿ
\:rage:	ğŸ˜¡
\:dolphin:	ğŸ¬
\rdiagovfdiag	â¤«
\mapsto	â†¦
\veemidvert	â©›
\:confounded:	ğŸ˜–
\maltese	âœ 
\leftouterjoin	âŸ•
\hslash	â„
\:satellite_antenna:	ğŸ“¡
\bbid	â…†
\nVleftarrow	â‡º
\circleonrightarrow	â‡´
\ttY	ğšˆ
\:factory:	ğŸ­
\blockhalfshaded	â–’
\brokenbar	Â¦
\blacksquare	â– 
\mdlgblkdiamond	â—†
\taurus	â™‰
\bisansi	ğ™
\frakW	ğ”š
\bbd	ğ••
\:ok_woman:	ğŸ™†
\bfq	ğª
\conjquant	â¨‡
\4/5	â…˜
\biPi	ğœ«
\:wrench:	ğŸ”§
\bisanspi	ğ¹
\:rice_scene:	ğŸ‘
\^8	â¸
\:heavy_dollar_sign:	ğŸ’²
\:man_and_woman_holding_hands:	ğŸ‘«
\^p	áµ–
\sum	âˆ‘
\:disguised_face:	ğŸ¥¸
\:chocolate_bar:	ğŸ«
\:sob:	ğŸ˜­
\aquarius	â™’
\sansS	ğ–²
\:end:	ğŸ”š
\:tophat:	ğŸ©
\uranus	â™…
\biepsilon	ğ
\isinvb	â‹¸
\oturnedcomma	Ì’
\bfvarepsilon	ğ›†
\nbumpeq	â‰Ì¸
\dashv	âŠ£
\:wrestlers:	ğŸ¤¼
\tth	ğš‘
\mdlgwhtdiamond	â—‡
\biZ	ğ’
\biGamma	ğœ
\bsansKappa	ğŸ
\:cactus:	ğŸŒµ
\:fallen_leaf:	ğŸ‚
\:oncoming_bus:	ğŸš
\gg	â‰«
\ngtrsim	â‰µ
\_s	â‚›
\bfrakB	ğ•­
\:adult:	ğŸ§‘
\glj	âª¤
\sqsupset	âŠ
\frakt	ğ”±
\diamond	â‹„
\Lap	â§Š
\:otter:	ğŸ¦¦
\otimesrhrim	â¨µ
\LeftUpTeeVector	â¥ 
\hexagon	â”
\risingdotseq	â‰“
\RightUpTeeVector	â¥œ
\:sweat:	ğŸ˜“
\:bread:	ğŸ
\bfEpsilon	ğš¬
\:pleading_face:	ğŸ¥º
\oe	Å“
\forall	âˆ€
\:green_apple:	ğŸ
\bbl	ğ•
\ttu	ğš
\bfDigamma	ğŸŠ
\:grin:	ğŸ˜
\rightarrowtriangle	â‡¾
\:boomerang:	ğŸªƒ
\leftarrowx	â¬¾
\:motor_scooter:	ğŸ›µ
\bba	ğ•’
\supset	âŠƒ
\supsim	â«ˆ
\:mans_shoe:	ğŸ‘
\equiv	â‰¡
\sharp	â™¯
\:clock730:	ğŸ•¢
\_2	â‚‚
\bbo	ğ• 
\epsilon	Ïµ
\bfMu	ğš³
\nrleg	Æ
\dualmap	â§Ÿ
\bigotimes	â¨‚
\bsansn	ğ—»
\vrecto	â–¯
\isinE	â‹¹
\:tennis:	ğŸ¾
\whitearrowupfrombar	â‡ª
\vrectangleblack	â–®
\:fondue:	ğŸ«•
\bsansO	ğ—¢
\scrQ	ğ’¬
\eqslantgtr	âª–
\strike	Ì¶
\scpolint	â¨“
\sansK	ğ–ª
\:older_woman:	ğŸ‘µ
\nwarrow	â†–
\bfzero	ğŸ
\_p	â‚š
\scry	ğ“
\:mrs_claus:	ğŸ¤¶
\bfvartheta	ğ›
\:upside_down_face:	ğŸ™ƒ
\leqq	â‰¦
\lfloor	âŒŠ
\:onion:	ğŸ§…
\:bear:	ğŸ»
\:tomato:	ğŸ…
\urtriangle	â—¹
\sphericalangle	âˆ¢
\ttm	ğš–
\biP	ğ‘·
\rLarr	â¥„
\boxtimes	âŠ 
\:i_love_you_hand_sign:	ğŸ¤Ÿ
\_i	áµ¢
\dottedcircle	â—Œ
\:new_moon:	ğŸŒ‘
\bfl	ğ¥
\gtquest	â©¼
\:seat:	ğŸ’º
\^r	Ê³
\wedgeodot	â©‘
\:face_with_cowboy_hat:	ğŸ¤ 
\interleave	â«´
\:sake:	ğŸ¶
\:u6e80:	ğŸˆµ
\complement	âˆ
\biL	ğ‘³
\ttw	ğš 
\biOmega	ğœ´
\simless	âª
\:burrito:	ğŸŒ¯
\sqsubsetneq	â‹¤
\Ddownarrow	â¤‹
\sansx	ğ—‘
\_rho	áµ¨
\itIota	ğ›ª
\:ice_cube:	ğŸ§Š
\upMu	Îœ
\:middle_finger:	ğŸ–•
\nVrightarrow	â‡»
\bscrU	ğ“¤
\:volleyball:	ğŸ
\isansq	ğ˜²
\:question:	â“
\minusfdots	â¨«
\bfF	ğ…
\diceiv	âšƒ
\Eta	Î—
\ll	â‰ª
\vartriangle	â–µ
\bfrakv	ğ–›
\Leftarrow	â‡
\asymp	â‰
\defas	â§‹
\:hushed:	ğŸ˜¯
\times	Ã—
\wr	â‰€
\ss	ÃŸ
\:umbrella:	â˜”
\upOmicron	ÎŸ
\:arrow_backward:	â—€
\suphsub	â«—
\:diamond_shape_with_a_dot_inside:	ğŸ’ 
\intcap	â¨™
\circleurquad	â—·
\gtcc	âª§
\:scroll:	ğŸ“œ
\:leaves:	ğŸƒ
\:shower:	ğŸš¿
\:sparkle:	â‡
\droang	Ìš
\:potted_plant:	ğŸª´
\:yawning_face:	ğŸ¥±
\leftarrowbackapprox	â­‚
\nvdash	âŠ¬
\biv	ğ’—
\bfTheta	ğš¯
\bisansm	ğ™¢
\dotsminusdots	âˆº
\:sparkler:	ğŸ‡
\oiiint	âˆ°
\:mirror:	ğŸª
\scrV	ğ’±
\questiondown	Â¿
\:face_palm:	ğŸ¤¦
\itN	ğ‘
\:icecream:	ğŸ¦
\:jeans:	ğŸ‘–
\ttA	ğ™°
\sansfive	ğŸ§
\succneq	âª²
\:wilted_flower:	ğŸ¥€
\:dress:	ğŸ‘—
\ttk	ğš”
\bfrakd	ğ–‰
\:place_of_worship:	ğŸ›
\underleftrightarrow	Í
\:ok_hand:	ğŸ‘Œ
\ttQ	ğš€
\intercal	âŠº
\bbs	ğ•¤
\emptysetoarrl	â¦´
\:bee:	ğŸ
\:aerial_tramway:	ğŸš¡
\ntrianglelefteq	â‹¬
\bigvee	â‹
\minus	âˆ’
\scrL	â„’
\bfp	ğ©
\submult	â«
\:peanuts:	ğŸ¥œ
\fourthroot	âˆœ
\:coin:	ğŸª™
\bisansQ	ğ™Œ
\lsime	âª
\:twisted_rightwards_arrows:	ğŸ”€
\dshfnc	â”†
\blackcircledrightdot	âšˆ
\:love_hotel:	ğŸ©
\bsansXi	ğ£
\scorpio	â™
\upharpoonright	â†¾
\ttx	ğš¡
\:clock5:	ğŸ•”
\:date:	ğŸ“…
\:dart:	ğŸ¯
\:dragon:	ğŸ‰
\:performing_arts:	ğŸ­
\sansm	ğ—†
\:clock12:	ğŸ•›
\bsansvartheta	ğ‹
\:heartpulse:	ğŸ’—
\sqfr	â—¨
\increment	âˆ†
\bftwo	ğŸ
\:runner:	ğŸƒ
\leftrightharpoonsup	â¥¦
\fraky	ğ”¶
\:link:	ğŸ”—
\bisanstau	ğ½
\1/5	â…•
\otimeshat	â¨¶
\bsansNu	ğ¢
\coprod	âˆ
\sansF	ğ–¥
\dblarrowupdown	â‡…
\isanst	ğ˜µ
\:no_entry:	â›”
\^epsilon	áµ‹
\cupdot	âŠ
\:test_tube:	ğŸ§ª
\:white_medium_square:	â—»
\scurel	âŠ±
\:ramen:	ğŸœ
\xrat	â„
\triangleminus	â¨º
\:camera_with_flash:	ğŸ“¸
\ddot	Ìˆ
\hexagonblack	â¬£
\blacklefthalfcircle	â—–
\:sparkling_heart:	ğŸ’–
\isansR	ğ˜™
\scrA	ğ’œ
\:bow:	ğŸ™‡
\:eight_pointed_black_star:	âœ´
\:frowning:	ğŸ˜¦
\bigcap	â‹‚
\bibeta	ğœ·
\:money_with_wings:	ğŸ’¸
\gesles	âª”
\:tokyo_tower:	ğŸ—¼
\hlmrk	Ë‘
\Upsilon	Î¥
\arceq	â‰˜
\:receipt:	ğŸ§¾
\LeftUpDownVector	â¥‘
\:lizard:	ğŸ¦
\sanse	ğ–¾
\:ab:	ğŸ†
\ltimes	â‹‰
\bbseven	ğŸŸ
\leftrightarrow	â†”
\^P	á´¾
\rightarrowbackapprox	â­ˆ
\:person_with_pouting_face:	ğŸ™
\varspadesuit	â™¤
\Mapsto	â¤‡
\:fencer:	ğŸ¤º
\:accept:	ğŸ‰‘
\bivarpi	ğ•
\:crocodile:	ğŸŠ
\:heavy_check_mark:	âœ”
\mid	âˆ£
\varisinobar	â‹¶
\sansT	ğ–³
\bfU	ğ”
\bivarrho	ğ”
\:parachute:	ğŸª‚
\sqfnw	â”™
\isansD	ğ˜‹
\:right-facing_fist:	ğŸ¤œ
\^=	â¼
\:ideograph_advantage:	ğŸ‰
\swarrow	â†™
\bar	Ì„
\bfrako	ğ–”
\rtlt	Êˆ
\biQ	ğ‘¸
\invnot	âŒ
\:bagel:	ğŸ¥¯
\biK	ğ‘²
\:fairy:	ğŸ§š
\subseteq	âŠ†
\squareneswfill	â–¨
\isansT	ğ˜›
\:scream_cat:	ğŸ™€
\:waving_black_flag:	ğŸ´
\LeftRightVector	â¥
\bfrakW	ğ–‚
\ittheta	ğœƒ
\gtreqqless	âªŒ
\Bot	â««
\:sunrise_over_mountains:	ğŸŒ„
\isansr	ğ˜³
\Longleftrightarrow	âŸº
\vdots	â‹®
\bigbot	âŸ˜
\:yo-yo:	ğŸª€
\:cheese_wedge:	ğŸ§€
\:hatching_chick:	ğŸ£
\varbarwedge	âŒ…
\bisansRho	ğ 
\bisansepsilon	ğŸ„
\:train:	ğŸš‹
\:coat:	ğŸ§¥
\:jigsaw:	ğŸ§©
\:envelope_with_arrow:	ğŸ“©
\mapsup	â†¥
\scrz	ğ“
\:beetle:	ğŸª²
\:clock6:	ğŸ••
\_9	â‚‰
\:bug:	ğŸ›
\bisansv	ğ™«
\Lleftarrow	â‡š
\:bike:	ğŸš²
\nearrow	â†—
\:rice_ball:	ğŸ™
\:musical_note:	ğŸµ
\:underage:	ğŸ”
\varnis	â‹»
\:rocket:	ğŸš€
\:grimacing:	ğŸ˜¬
\bfy	ğ²
\backpprime	â€¶
\th	Ã¾
\:snowman:	â›„
\bscrZ	ğ“©
\frakT	ğ”—
\:cockroach:	ğŸª³
\:kissing_cat:	ğŸ˜½
\Searrow	â‡˜
\tte	ğš
\:sound:	ğŸ”‰
\bfrakz	ğ–Ÿ
\breve	Ì†
\angleubar	â¦¤
\hatapprox	â©¯
\:koala:	ğŸ¨
\closedvarcupsmashprod	â©
\succeq	âª°
\itq	ğ‘
\nwovnearrow	â¤²
\:woozy_face:	ğŸ¥´
\isansQ	ğ˜˜
\:pinched_fingers:	ğŸ¤Œ
\bsansfive	ğŸ±
\suphsol	âŸ‰
\:roller_skate:	ğŸ›¼
\plushat	â¨£
\bisansZ	ğ™•
\^L	á´¸
\int	âˆ«
\curlyeqprec	â‹
\rightarrowplus	â¥…
\sansY	ğ–¸
\bsansrho	ğ€
\:cop:	ğŸ‘®
\:mahjong:	ğŸ€„
\bscrv	ğ“¿
\bscrW	ğ“¦
\neovsearrow	â¤®
\:watermelon:	ğŸ‰
\:virgo:	â™
\:person_doing_cartwheel:	ğŸ¤¸
\:tiger:	ğŸ¯
\:leopard:	ğŸ†
\UpArrowBar	â¤’
\bfAlpha	ğš¨
\:bison:	ğŸ¦¬
\:tropical_drink:	ğŸ¹
\bfs	ğ¬
\:cloud:	â˜
\itpsi	ğœ“
\^+	âº
\:probing_cane:	ğŸ¦¯
\:nut_and_bolt:	ğŸ”©
\lgE	âª‘
\bffive	ğŸ“
\trnh	É¥
\boxbslash	â§…
\equalparallel	â‹•
\cirfnint	â¨
\biz	ğ’›
\bbi	ğ•š
\bisansvarkappa	ğŸ†
\itepsilon	ğœ–
\nLeftrightarrow	â‡
\itomega	ğœ”
\hrectangle	â–­
\bbM	ğ•„
\:closed_book:	ğŸ“•
\bfX	ğ—
\:eagle:	ğŸ¦…
\precnapprox	âª¹
\:soap:	ğŸ§¼
\:running_shirt_with_sash:	ğŸ½
\:older_adult:	ğŸ§“
\precapprox	âª·
\pentagonblack	â¬Ÿ
\curvearrowright	â†·
\:movie_camera:	ğŸ¥
\sansi	ğ—‚
\:arrow_up_small:	ğŸ”¼
\:spades:	â™ 
\blacktriangledown	â–¾
\:pushpin:	ğŸ“Œ
\squoval	â–¢
\:rabbit:	ğŸ°
\sqsubset	âŠ
\underrightharpoondown	âƒ¬
\:floppy_disk:	ğŸ’¾
\:information_source:	â„¹
\itPhi	ğ›·
\:man:	ğŸ‘¨
\biJ	ğ‘±
\bisansOmega	ğ¨
\:accordion:	ğŸª—
\bin	ğ’
\bsansJ	ğ—
\:stuck_out_tongue:	ğŸ˜›
\:dango:	ğŸ¡
\smblklozenge	â¬ª
\trapezium	â¢
\bullseye	â—
\:genie:	ğŸ§
\scro	â„´
\:teapot:	ğŸ«–
\leftrightsquigarrow	â†­
\^t	áµ—
\Sigma	Î£
\:no_entry_sign:	ğŸš«
\longmapsto	âŸ¼
\bbnine	ğŸ¡
\:new:	ğŸ†•
\itdelta	ğ›¿
\virgo	â™
\:1234:	ğŸ”¢
\isansL	ğ˜“
\boxast	â§†
\bfUpsilon	ğš¼
\csupe	â«’
\drbkarrow	â¤
\bfrakY	ğ–„
\bscrl	ğ“µ
\ell	â„“
\:interrobang:	â‰
\:japanese_goblin:	ğŸ‘º
\sansN	ğ–­
\:zany_face:	ğŸ¤ª
\:wink:	ğŸ˜‰
\tau	Ï„
\bsanse	ğ—²
\sanszero	ğŸ¢
\twoheadleftarrow	â†
\:bricks:	ğŸ§±
\Uparrow	â‡‘
\bfeight	ğŸ–
\rightdasharrow	â‡¢
\sanst	ğ—
\bisansu	ğ™ª
\isansz	ğ˜»
\sansO	ğ–®
\nolinebreak	â 
\rangle	âŸ©
\:art:	ğŸ¨
\:soon:	ğŸ”œ
\:cry:	ğŸ˜¢
\libra	â™
\:mountain_bicyclist:	ğŸšµ
\Lambda	Î›
\esh	Êƒ
\:rolling_on_the_floor_laughing:	ğŸ¤£
\sqsupseteq	âŠ’
\:moon_cake:	ğŸ¥®
\_r	áµ£
\tieconcat	â€
\:bowling:	ğŸ³
\bsansm	ğ—º
\supseteqq	â«†
\csup	â«
\Rdsh	â†³
\varveebar	â©¡
\bfrakx	ğ–
\bilambda	ğ€
\k	Ì¨
\:dumpling:	ğŸ¥Ÿ
\nparallel	âˆ¦
\^n	â¿
\conictaper	âŒ²
\biBeta	ğœ
\:confused:	ğŸ˜•
\:black_joker:	ğŸƒ
\:partying_face:	ğŸ¥³
\scrw	ğ“Œ
\ttthree	ğŸ¹
\bix	ğ’™
\mdwhtcircle	âšª
\bisansrho	ğº
\dotsim	â©ª
\coloneq	â‰”
\pisces	â™“
\:smiley_cat:	ğŸ˜º
\:white_check_mark:	âœ…
\preceqq	âª³
\bscrz	ğ”ƒ
\RightVectorBar	â¥“
\vysmblksquare	â¬
\bfnine	ğŸ—
\:prince:	ğŸ¤´
\sansf	ğ–¿
\upharpoonleft	â†¿
\sansl	ğ—…
\itChi	ğ›¸
\^U	áµ
\:shrug:	ğŸ¤·
\bisansI	ğ™„
\biIota	ğœ¤
\:person_with_headscarf:	ğŸ§•
\bisansdelta	ğ­
\:yellow_heart:	ğŸ’›
\frakw	ğ”´
\bisansKappa	ğ™
\bfIota	ğš°
\:skateboard:	ğŸ›¹
\:four_leaf_clover:	ğŸ€
\rtll	É­
\bim	ğ’
\sout	Ì¶
\precsim	â‰¾
\invw	Ê
\^E	á´±
\:tanabata_tree:	ğŸ‹
\upkoppa	ÏŸ
\bsansOmega	ğ®
\isansH	ğ˜
\:cherries:	ğŸ’
\:notebook:	ğŸ““
\notin	âˆ‰
\frakl	ğ”©
\:custard:	ğŸ®
\:arrow_lower_left:	â†™
\:seal:	ğŸ¦­
\:nesting_dolls:	ğŸª†
\_beta	áµ¦
\sansR	ğ–±
\:pancakes:	ğŸ¥
\:memo:	ğŸ“
\prime	â€²
\biH	ğ‘¯
\itomicron	ğœŠ
\:last_quarter_moon:	ğŸŒ—
\Angstrom	â„«
\isansh	ğ˜©
\cdot	â‹…
\blockuphalf	â–€
\leftthreearrows	â¬±
\bid	ğ’…
\rtimes	â‹Š
\bisansvarTheta	ğ¡
\:slot_machine:	ğŸ°
\circledtwodots	âš‡
\nmid	âˆ¤
\sansnine	ğŸ«
\trianglecdot	â—¬
\bfZeta	ğš­
\^j	Ê²
\bsansh	ğ—µ
\:womans_flat_shoe:	ğŸ¥¿
\ldots	â€¦
\scrx	ğ“
\DownLeftVectorBar	â¥–
\Supset	â‹‘
\mdblklozenge	â¬§
\itvarsigma	ğœ
\:bamboo:	ğŸ
\bif	ğ’‡
\pgamma	É£
\midbarvee	â©
\:part_alternation_mark:	ã€½
\RightUpDownVector	â¥
\:swan:	ğŸ¦¢
\:mate_drink:	ğŸ§‰
\:sandal:	ğŸ‘¡
\:baseball:	âš¾
\bfH	ğ‡
\bscrh	ğ“±
\upharpoonsleftright	â¥£
\varpi	Ï–
\:tulip:	ğŸŒ·
\circledast	âŠ›
\smalltriangleright	â–¹
\:black_small_square:	â–ª
\:airplane_arriving:	ğŸ›¬
\:zipper_mouth_face:	ğŸ¤
\^beta	áµ
\bigtop	âŸ™
\bipi	ğ…
\frakh	ğ”¥
\:waning_gibbous_moon:	ğŸŒ–
\:triangular_ruler:	ğŸ“
\_chi	áµª
\scrf	ğ’»
\sqfse	â—ª
\rightharpoonupdash	â¥¬
\^a	áµƒ
\^v	áµ›
\bisansV	ğ™‘
\:octagonal_sign:	ğŸ›‘
\:articulated_lorry:	ğŸš›
\eqsim	â‰‚
\:ski:	ğŸ¿
\whiteinwhitetriangle	âŸ
\pupsil	ÊŠ
\:straight_ruler:	ğŸ“
\tona	â¤§
\isansw	ğ˜¸
\nsqsubseteq	â‹¢
\lesdot	â©¿
\scrl	ğ“
\bbO	ğ•†
\:tumbler_glass:	ğŸ¥ƒ
\therefore	âˆ´
\leftarrowtail	â†¢
\scre	â„¯
\smallni	âˆ
\iti	ğ‘–
\measuredangle	âˆ¡
\bfrakK	ğ•¶
\LeftTeeVector	â¥š
\bisansvarphi	ğ¿
\sansk	ğ—„
\:night_with_stars:	ğŸŒƒ
\:dizzy_face:	ğŸ˜µ
\scrr	ğ“‡
\:cookie:	ğŸª
\:inbox_tray:	ğŸ“¥
\reglst	Ê•
\biW	ğ‘¾
\bsansnine	ğŸµ
\intprod	â¨¼
\frakn	ğ”«
\:cow:	ğŸ®
\whitepointerleft	â—…
\^A	á´¬
\:lion_face:	ğŸ¦
\scrF	â„±
\:bowl_with_spoon:	ğŸ¥£
\3/8	â…œ
\:cat2:	ğŸˆ
\rtlr	É½
\subsub	â«•
\frakz	ğ”·
\strns	â¤
\gtrsim	â‰³
\uparrowbarred	â¤‰
\bidelta	ğœ¹
\:mango:	ğŸ¥­
\adots	â‹°
\downdasharrow	â‡£
\dh	Ã°
\:loudspeaker:	ğŸ“¢
\:monorail:	ğŸš
\gla	âª¥
\:spaghetti:	ğŸ
\:hatched_chick:	ğŸ¥
\:sunrise:	ğŸŒ…
\bfthree	ğŸ‘
\:woman:	ğŸ‘©
\mdsmwhtcircle	âš¬
\bfEta	ğš®
\eqdot	â©¦
\biPsi	ğœ³
\ittau	ğœ
\:man_with_turban:	ğŸ‘³
\:ladybug:	ğŸ
\:bullettrain_front:	ğŸš…
\:sloth:	ğŸ¦¥
\oiint	âˆ¯
\bbS	ğ•Š
\:scissors:	âœ‚
\searrow	â†˜
\nvtwoheadrightarrow	â¤€
\:hankey:	ğŸ’©
\:carrot:	ğŸ¥•
\bfrakj	ğ–
\biDelta	ğœŸ
\:fly:	ğŸª°
\scrh	ğ’½
\diceii	âš
\:clinking_glasses:	ğŸ¥‚
\cirfl	â—
\:doughnut:	ğŸ©
\:e-mail:	ğŸ“§
\frakV	ğ”™
\longleftsquigarrow	â¬³
\:feather:	ğŸª¶
\:dog2:	ğŸ•
\bic	ğ’„
\boxdiag	â§„
\:face_with_rolling_eyes:	ğŸ™„
\itKappa	ğ›«
\:grey_exclamation:	â•
\:ear_of_rice:	ğŸŒ¾
\linefeed	â†´
\ttJ	ğ™¹
\bisanseta	ğ°
\varsigma	Ï‚
\bfrakO	ğ•º
\dyogh	Ê¤
\:scream:	ğŸ˜±
\mdblksquare	â—¼
\:japanese_ogre:	ğŸ‘¹
\scrB	â„¬
\:large_green_circle:	ğŸŸ¢
\sqrint	â¨–
\bipartial	ğ
\:badminton_racquet_and_shuttlecock:	ğŸ¸
\:fishing_pole_and_fish:	ğŸ£
\nu	Î½
\leftrightharpoons	â‡‹
\:weary:	ğŸ˜©
\ddots	â‹±
\:brown_heart:	ğŸ¤
\flat	â™­
\itTheta	ğ›©
\sansu	ğ—
\lnapprox	âª‰
\npolint	â¨”
\bisansiota	ğ²
\bscre	ğ“®
\:u7a7a:	ğŸˆ³
\astrosun	â˜‰
\:milky_way:	ğŸŒŒ
\:m:	â“‚
\:abacus:	ğŸ§®
\:snowboarder:	ğŸ‚
\simplus	â¨¤
\:capricorn:	â™‘
\scrS	ğ’®
\bsansEpsilon	ğš
\:maple_leaf:	ğŸ
\bisansEpsilon	ğ”
\:pisces:	â™“
\:chart_with_downwards_trend:	ğŸ“‰
\upvarbeta	Ï
\bisansomicron	ğ¸
\mdlgblkcircle	â—
\:evergreen_tree:	ğŸŒ²
\RightDownVectorBar	â¥•
\odiv	â¨¸
\late	âª­
\bscrt	ğ“½
\odotslashdot	â¦¼
\sansD	ğ–£
\bbq	ğ•¢
\indep	â««
\isinobar	â‹·
\bsansepsilon	ğŠ
\eqeqeq	â©¶
\:satellite:	ğŸ“¡
\neuter	âš²
\:stuffed_flatbread:	ğŸ¥™
\:sparkles:	âœ¨
\:sushi:	ğŸ£
\:safety_vest:	ğŸ¦º
\frakH	â„Œ
\squareulblack	â—©
\:seedling:	ğŸŒ±
\isansn	ğ˜¯
\leftharpoonsupdown	â¥¢
\:mailbox:	ğŸ“«
\:monkey_face:	ğŸµ
\:mouse2:	ğŸ
\geqslant	â©¾
\^c	á¶œ
\:sandwich:	ğŸ¥ª
\:canned_food:	ğŸ¥«
\awint	â¨‘
\LeftDownVectorBar	â¥™
\bisanspsi	ğŸ
\veeeq	â‰š
\itPi	ğ›±
\nsucceq	âª°Ì¸
\obslash	â¦¸
\bsansvarsigma	ğ
\^K	á´·
\:scorpius:	â™
\:crown:	ğŸ‘‘
\squarellquad	â—±
\bfR	ğ‘
\:clock1:	ğŸ•
\bisansPhi	ğ¥
\:partly_sunny:	â›…
\vartriangleright	âŠ³
\bisansBeta	ğ‘
\nsupseteqq	â«†Ì¸
\bisansUpsilon	ğ¤
\:cut_of_meat:	ğŸ¥©
\:supervillain:	ğŸ¦¹
\subsup	â«“
\:face_with_hand_over_mouth:	ğŸ¤­
\:tongue:	ğŸ‘…
\NestedLessLess	âª¡
\o	Ã¸
\bixi	ğƒ
\triangleright	â–·
\:walking:	ğŸš¶
\bfw	ğ°
\bbE	ğ”¼
\geq	â‰¥
\ttS	ğš‚
\urarc	â—
\bbL	ğ•ƒ
\bfKappa	ğš±
\rightarrowtail	â†£
\diceiii	âš‚
\bis	ğ’”
\^chi	áµ¡
\multimap	âŠ¸
\Delta	Î”
\:space_invader:	ğŸ‘¾
\leqqslant	â«¹
\Rho	Î¡
\bfh	ğ¡
\:large_brown_square:	ğŸŸ«
\bfj	ğ£
\topsemicircle	â— 
\itpartial	ğœ•
\:black_square_button:	ğŸ”²
\highminus	Â¯
\LeftDownTeeVector	â¥¡
\ttt	ğš
\:house_with_garden:	ğŸ¡
\itR	ğ‘…
\nvLeftarrow	â¤‚
\bisansZeta	ğ•
\circlearrowright	â†»
\frakZ	â„¨
\bfrakT	ğ•¿
\scrp	ğ“…
\:sweat_smile:	ğŸ˜…
\sansX	ğ–·
\:wave:	ğŸ‘‹
\bscrG	ğ“–
\succnsim	â‹©
\bfn	ğ§
\bsanssigma	ğ‚
\:call_me_hand:	ğŸ¤™
\bsansPhi	ğ«
\isansk	ğ˜¬
\:cupcake:	ğŸ§
\bsansw	ğ˜„
\:large_purple_square:	ğŸŸª
\:turkey:	ğŸ¦ƒ
\quad	â€ƒ
\eqqgtr	âªš
\bfI	ğˆ
\:sleeping:	ğŸ˜´
\ity	ğ‘¦
\ltln	É²
\:sun_with_face:	ğŸŒ
\RightTriangleBar	â§
\:lacrosse:	ğŸ¥
\:menorah_with_nine_branches:	ğŸ•
\:customs:	ğŸ›ƒ
\Subset	â‹
\:flying_disc:	ğŸ¥
\:camera:	ğŸ“·
\:bath:	ğŸ›€
\Rlarr	â¥‚
\:flags:	ğŸ
\:arrow_up:	â¬†
\leftmoon	â˜¾
\:mailbox_with_mail:	ğŸ“¬
\_+	â‚Š
\:alarm_clock:	â°
\:mobile_phone_off:	ğŸ“´
\bfY	ğ˜
\:signal_strength:	ğŸ“¶
\nleq	â‰°
\:no_smoking:	ğŸš­
\:office:	ğŸ¢
\biPhi	ğœ±
\pprime	â€³
\bfO	ğ
\vee	âˆ¨
\bivarkappa	ğ’
\frakv	ğ”³
\:avocado:	ğŸ¥‘
\RightTeeVector	â¥›
\:last_quarter_moon_with_face:	ğŸŒœ
\ttR	ğš
\:synagogue:	ğŸ•
\:hindu_temple:	ğŸ›•
\rightharpoonup	â‡€
\:star-struck:	ğŸ¤©
\:pig:	ğŸ·
\:couple_with_heart:	ğŸ’‘
\upand	â…‹
\geqq	â‰§
\itB	ğµ
\rmoustache	â±
\u	Ë˜
\bbpi	â„¼
\intBar	â¨
\Epsilon	Î•
\1/10	â…’
\:convenience_store:	ğŸª
\leftrightharpoondownup	â¥‹
\rightharpoonaccent	âƒ‘
\itJ	ğ½
\:bucket:	ğŸª£
\RightDownTeeVector	â¥
\bisansw	ğ™¬
\:broccoli:	ğŸ¥¦
\mu	Î¼
\sansI	ğ–¨
\:paperclip:	ğŸ“
\1/7	â…
\:open_file_folder:	ğŸ“‚
\diamondrightblack	â¬—
\:parking:	ğŸ…¿
\bfx	ğ±
\:large_purple_circle:	ğŸŸ£
\exclamdown	Â¡
\biRho	ğœ¬
\gneq	âªˆ
\:clock1030:	ğŸ•¥
\:postbox:	ğŸ“®
\itn	ğ‘›
\curvearrowleft	â†¶
\nlesssim	â‰´
\frakp	ğ”­
\mercury	â˜¿
\bscrF	ğ“•
\isansW	ğ˜
\le	â‰¤
\:city_sunrise:	ğŸŒ‡
\leftcurvedarrow	â¬¿
\tttwo	ğŸ¸
\bfD	ğƒ
\:curry:	ğŸ›
\:droplet:	ğŸ’§
\bfupsilon	ğ›–
\hermaphrodite	âš¥
\:hourglass_flowing_sand:	â³
\:ladder:	ğŸªœ
\ulcorner	âŒœ
\hbar	Ä§
\itZ	ğ‘
\varepsilon	Îµ
\tty	ğš¢
\bsansTau	ğ©
\intprodr	â¨½
\bsimilarrightarrow	â­‡
\downarrow	â†“
\eulermascheroni	â„‡
\:stuck_out_tongue_closed_eyes:	ğŸ˜
\:handshake:	ğŸ¤
\:point_left:	ğŸ‘ˆ
\downarrowbarred	â¤ˆ
\:disappointed_relieved:	ğŸ˜¥
\:shrimp:	ğŸ¦
\leq	â‰¤
\sansC	ğ–¢
\:bookmark:	ğŸ”–
\:trophy:	ğŸ†
\parallel	âˆ¥
\squarehfill	â–¤
\scru	ğ“Š
\bsansSigma	ğ¨
\PropertyLine	â…Š
\leftleftarrows	â‡‡
\nvDash	âŠ­
\frakm	ğ”ª
\:amphora:	ğŸº
\bsansphi	ğ
\:leftwards_arrow_with_hook:	â†©
\:bicyclist:	ğŸš´
\bbc	ğ•”
\:boat:	â›µ
\updasharrow	â‡¡
\bisansP	ğ™‹
\:drooling_face:	ğŸ¤¤
\bsansx	ğ˜…
\^-	â»
\:spoon:	ğŸ¥„
\:kissing_heart:	ğŸ˜˜
\sansz	ğ—“
\bfRho	ğš¸
\ttZ	ğš‰
\:circus_tent:	ğŸª
\oplus	âŠ•
\uminus	â©
\ttV	ğš…
\itH	ğ»
\updownarrow	â†•
\itG	ğº
\sansW	ğ–¶
\cup	âˆª
\ringplus	â¨¢
\lsimg	âª
\ttone	ğŸ·
\itm	ğ‘š
\:triumph:	ğŸ˜¤
\Or	â©”
\lsqhook	â«
\rdiagovsearrow	â¤°
\bscrp	ğ“¹
\bbr	ğ•£
\tesh	Ê§
\bbP	â„™
\scrG	ğ’¢
\trianglerighteq	âŠµ
\:nerd_face:	ğŸ¤“
\emptysetocirc	â¦²
\Coloneq	â©´
\:turtle:	ğŸ¢
\euler	â„¯
\:new_moon_with_face:	ğŸŒš
\AA	Ã…
\frakj	ğ”§
\bfalpha	ğ›‚
\bfB	ğ
\exists	âˆƒ
\:fearful:	ğŸ˜¨
\:key:	ğŸ”‘
\bscrJ	ğ“™
\Uuparrow	â¤Š
\:pill:	ğŸ’Š
\biMu	ğœ§
\bsansomicron	ğ¾
\thickspace	â€…
\endash	â€“
\bisansvartheta	ğŸ…
\ttl	ğš•
\:pencil2:	âœ
\bsansQ	ğ—¤
\bizeta	ğœ»
\bsansvarTheta	ğ§
\bbsemi	â¨Ÿ
\gesdoto	âª‚
\:foggy:	ğŸŒ
\:diya_lamp:	ğŸª”
\:flatbread:	ğŸ«“
\:hibiscus:	ğŸŒº
\smt	âªª
\scrP	ğ’«
\bscrb	ğ“«
\:necktie:	ğŸ‘”
\trna	É
\:orange_heart:	ğŸ§¡
\veedot	âŸ‡
\wideangledown	â¦¦
\bisanse	ğ™š
\bby	ğ•ª
\nor	âŠ½
\subsetdot	âª½
\turnediota	â„©
\:telephone_receiver:	ğŸ“
\bscrj	ğ“³
\scrD	ğ’Ÿ
\frakP	ğ”“
\:palms_up_together:	ğŸ¤²
\:lollipop:	ğŸ­
\:heart:	â¤
\tripleplus	â§»
\vertoverlay	âƒ’
\:dancers:	ğŸ‘¯
\nabla	âˆ‡
\:iphone:	ğŸ“±
\Cup	â‹“
\propto	âˆ
\rtln	É³
\bfPsi	ğš¿
\:libra:	â™
\ite	ğ‘’
\:no_bicycles:	ğŸš³
\biomega	ğ
\bbij	â…‰
\rq	â€™
\bsansy	ğ˜†
\leftarrowsubset	â¥º
